acerbic	尖酸的，刻薄的	acer=acri=bitter,sharp,sour
acrimony	尖酸刻薄的，激烈的	acer=acri=bitter,sharp,sour
actuate	开动，促使	act（active）
agrarian	土地的	agr(o)=agr(i)=field
ambivalent	（对人或物）有矛盾看法的	ambi=both, on both sides； ambi + value
amiable	和蔼的，友善的	ami=fried
amicable	友好的	ami=fried
anaerobic	厌氧的；厌氧微生物	an=against；aero=air, atomsphere
anachronistic	时代错误的	ana=against；chron=time
anathema	诅咒，逐出教门	ana=against；the=god
animosity	憎恨，仇恨	anim(=enmity)
antagonism	对抗，敌对	ant=against, agony 痛苦
accede	同意	ced=ceed=cess=go
adept	熟练的，擅长的	ept 能力
aberrant	越轨的，异常的	err=stray 迷路，偏离，漂泊；errant 周游的，不定的，错误的
affable	和蔼的，友善的	fable 寓言
affront	侮辱，冒犯	front=forehead，点着前额说
allude	暗指，间接提到	lud=lus=play 玩耍，游戏，戏剧（影射现实）
allusive	暗指的，间接提到的	lud=lus=play 玩耍，游戏，戏剧（影射现实）
ameliorate	改善，改良	melior=better
admonish	训诫，警告	mon=warn
amorphous	无固定形状的	morph=form, shape
annex	兼并，合并	one next one
adorn	装饰	orn=decorate 装饰
acquiesce	默认，默许	qui=rest
abrasive	研磨的	ras=raz=rad=scrape‘刮擦’
abstain	禁绝，放弃	tain=hold；abs=away
abstruse	难懂的，深奥的	trus=push；abs=away；无法推进
adumbrate	预示	umbr=shade, shadow
airborne	空运的，通过空气传播的	waterborne 水运的，通过水传播的
amble	漫步缓行	安步当车，缓缓而行
angular	生硬的，笨拙的	机器人动作棱角（angle）分明
abate	减少，降低	区分abet 怂恿，唆使
agile	敏捷的	天使（angel）一样轻灵
amenable	顺从的，愿意接受的	音：阿门（接受并尊重）
accredit	授权	
adulation	奉承，谄媚	
allegiance	忠诚，拥护	
allegory	寓言	
aloof	远离的，冷漠的	
bashfulness	羞怯	abash 局促，羞惭
antipathy	反感，厌恶	ant=against 反 + path=feeling 感 = 反感
antiquarianism	古物研究	antique 古董
antiquated	陈旧的	antique 古董
apparition	幽灵，灵异景象	appar(=appear）
approbation	赞许，认可	approb(=approve）
apprise	通知	APP弹出（rise）对话框，通知用户新的信息
apropos	适当的（地）；有关	apropos≈proper
aptitude	适宜；资质	apt “能力”
arable	适于耕种的	ara=plow 耕、犁
arboreal	树木的	arbor=tree
arcane	秘密的	arcan=box
archaeological	考古学的	archae=ancient；log=logy=word,speech,thought
archaic	古老的	archai(=archae)=ancient
arduous	艰难的，费力的	ardu=difficult
arid	干旱的，枯燥的	arid=be dry
armored	披甲的	armour 甲胄，装甲；arm 武装
astound	使震惊	astonish
astute	机敏的，精明的	astus 灵活
atonement	弥补，赎罪	at one
atrocity	邪恶，暴行	atroc=cruel
ballad	歌谣	ball 舞会
banish	放逐	ban 禁令，根据禁令将人放逐
beaded	以珠宝装饰的	bead 珠宝
bellicose	好战的	bell=belli=war
anticlimactic	突减的	climc=climax
belie	掩饰，证伪	lie 撒谎，掩饰
appall	使惊骇	pal（=pale） 惊吓脸色苍白
apathetic	无感情的，无兴趣的	path=feeling，without feeling
appease	安抚	pease(=peace)
apex	最高点	pex(=peak)
aphorism	格言	phor=bear,carry
apportion	（按比例或计划）分配	portion
apposite	适当的	posit=pos=put
apprehensive	害怕的，领悟的	prehend=grasp
appropriate	恰当的；拨款，盗用	propri=one's own, owership
ascribe	归咎于	scrib=script=write
antiseptic	防腐的；杀菌剂	sept=to rot
aseptic	净化的，无菌的	sept=to rot
assiduous	勤勉的，专心的	sid=sed=sit
astigmatic	散光的；敌视的	stigma 污点，眼中有污点
astray	迷路的，误入歧途的	stray 走离
attenuate	消瘦；减少（弱）	tenu=thin，大事化小小事化了
attest	证实，证明	test
antithesis	对立	the=put
antithetical	对立的，相反的	the=put
attrition	摩擦，磨损	tri=trit=rud摩擦
atrophy	微缩，衰退	troph=grow
attune	使调和	tune,tone
avarice	贪婪	各种各样的（various）东西都想要
auspice	预测，占卜，吉兆；赞助，支持	根据鸟的行为发现未来事物的预兆
auspicious	吉兆的，幸运的	根据鸟的行为发现未来事物的预兆
asunder	分离的（地），化为碎片的（地）	一声惊雷（thunder），玻璃纷飞
aroma	芳香	音：啊，肉末
assail	质问，攻击	战舰起航（sail）发起猛烈攻击
ascetic	禁欲的；苦行者	
aspen	白杨树	
assorted	多样的，混杂的	
assuming	假定；傲慢的，自负的	
audacious	大胆的	
austere	严肃的，严峻的；朴素的	
avid	渴望的	
avocation	副业，嗜好	
balk	阻碍；梁木	
banal	乏味的	
bane	祸根，毒药	
banter	打趣	
bask	晒太阳，取暖	
bastion	防御工事，堡垒	
beleaguer	围攻，骚扰	
belligerent	好战的	bell=belli=war
benefactor	行善者	ben=good,well；fact=do,make
bonanza	金属矿	bon=good
braggart	牛皮大王	brag 吹嘘
brassy	厚颜无耻的，无礼的	brass 黄铜，黄铜制品，厚脸皮
brazen	厚颜无耻的	brass 黄铜，黄铜制品，厚脸皮
breach	打破，违背；裂缝	break
cacophony	刺耳的声音	caco=bad；phon=sound
capitulate	（有条件地）投降	capit=head 低头屈服
capricious	反复无常的，任性的	capr=goat 山羊性格多变
captious	吹毛求疵的	capt=hold, take 抓住一点就不放
cardinal	主要的，首要的；红衣教主	card=cord=heart 处于核心位置的
cavity	（牙齿等）洞	cav=hole,hollow
censorious	挑剔的	cens=assess
ceramic	陶器的；陶瓷制品	ceram=clay 粘土
cerebral	大脑的，深思的	cerebr=brain
certitude	确定的	certain
chivalrous	骑士精神的，对女人彬彬有礼的	chival(=caval)=horse
circumlocution	迂回累赘的陈述	circum=around, locu=loqu=speak
canny	谨慎的，精明的，节约的	cunny 狡猾的，精巧的；诡计，技巧
bereave	夺去，丧亲	reave 剥夺，抢走
briad	编织；穗子，发辫	本身也是词根
chary	小心的	东西烧焦（char）了，一定要小心
caterpillar	毛虫	法语：多毛的猫（cat）
chancy	不确定的，不安的	几率（chance）不等，各种不确定
charlatan	骗子	意大利Charlat一度因江湖医生文明
cessation	中断，终止	源于cease
ceremonious	仪式隆重的	源于ceremony
bemuse	使困惑，使昏头昏脑	
beset	镶嵌；困扰	
besiege	围攻，困扰	
bestow	赠予，给予	
bewilder	使迷惑	
bland	（人）情绪平稳的，（食物）无味的	
blatant	厚颜无耻的；显眼的，炫耀的	
bleach	漂白；漂白剂	
blighted	枯萎的	
bliss	幸福，快乐；福气	
blithe	快乐的	
blockbuster	一鸣惊人的事物，成功的书或电影；巨型炸弹	
bluff	虚张声势，悬崖峭壁	
boisterous	喧闹的，猛烈的	
bolster	支持；枕垫	
bombastic	夸夸其谈的	
boon	天赐福利，恩惠	
bootless	无益的	
briny	咸的	
brusquen	寡言的，无礼的	
buckle	扣紧；皮带扣环	
bulky	庞大的，笨重的	
bumper	特大的；保险杠	
buoyant	有浮力的；快乐的	
buttress	支持；拱墙	
calamity	大灾祸	
callous	结硬块的，无情的	
calumny	诽谤	
candid	率直的	
candor	率直，坦白	
cantankerous	脾气坏的，好争吵的	
caricature	讽刺画，滑稽模仿	
castigate	惩治，严责	
catalyze	促使，激励	
cavil	吹毛求疵	
celestial	天体的，天上的	
celibate	不结婚的；独身者	
censure	指责	
chafe	（将皮肤等）擦热，擦破；激怒	
chagrin	失望，懊恼	
chantey	船歌	
chastise	惩罚，责难	
choppy	波浪起伏的；（风）不断改变方向的	
chubby	丰满的	
concentric	同心的	centr=centri=center
conciliate	安抚，调和，取悦	cili=eyelash 睫毛
clamor	喧哗的；大声疾呼	clam=cry out
clannish	排他的	clan 宗派，宗族
claustrophobic	患幽闭恐惧症的	claus=close,shut；phob=fear
climactic	高潮的	climac=climax
clamber	吃力攀爬	climb的重复动词：爬啊爬
concoction	混合物	coct=cook 一起煮
concomitant	伴随的	comit=companion
cleave	劈开	cut, then two sides leave
condescend	谦逊，屈尊	descend
confide	倾诉，吐露（心事）	fid=faith,trust；向知心的人倾诉
conflagration	（建筑物或森林）大火	flagr=flam=blaze 火焰
coax	哄骗	hoax,coax 欺骗
conjure	召唤，想起；变戏法	jur=swear,law
colloquial	口语的，口头的	loqu=speak
collusion	共谋，勾结	lus=lud=play
commensurate	同样大小的，相称的	mensur=measure
compendium	概要	pendulum 钟摆
complacent	自满的，得意的	plac=please
clutter	弄乱	utter 发声，发射，流通；向整洁的(clean)环境发射导弹，一片狼藉
condone	原谅	对做过的事（done）不再追究
conscientious	尽责的，谨慎的	有良心（conscience）的人做事情一定尽职尽责
composure	沉着	源于compose
clement	温和的，仁厚的	
cliche	陈词滥调	
coalesce	联合，合并	
coerce	强迫，压制	
cogent	有说服力的	
coherent	一致的	
colossal	庞大的	
combustible	易燃的，冲动的	
commiserate	同情	
commodious	宽敞的	
communal	共享的，全体公用的	
conflate	合并	
confound	迷惑，搞混	
confront	对抗	
congenial	趣味相投的	
congenital	天生的	
conifer	针叶树	
connive	默许，纵容；共谋	
connoisseur	鉴赏家，行家	
connotation	内涵，言外之意	
consort	陪伴；配偶	
consternation	惊骇	
debilitate	使衰弱，使虚弱	bili=able
deciduous	短暂的，脱落的，落叶的	cid=cis=cut, kill；de=depart
cordiality	热诚，诚恳	cord=heart
credulous	轻信的，易骗的	cred=believe, trust
creed	教义，信条	creed=cred=believe, trust
crestfallen	挫败的，失望的	crest 冠，头盔顶部
culinary	厨房的，烹调的	culin=kitchen
culminate	达到最高点的	culmin=top
culpable	有罪的	culp=fault
decadence	衰落	decay
deft	灵巧的，熟练的	dexterous
counterfeit	伪造（的）	feit=do,make
crook	钩状物，（河、道的）弯处，骗子；欺骗，弯曲	rook 欺骗；骗子
construe	解释，翻译	stru=struc=build, make up
containment	阻止，遏制；保留，保持	tain=hold
contrite	悔罪的，痛悔的	tri=trit=rud摩擦
contravene	违背（法规、习俗等）	ven=vent=come；contra=against
conversant	精通的	vers=turn 同时（con）了解多个方面（turns）
convivial	欢乐的	viv=life
convoluted	旋转的；费解的	volut=roll
decimate	重创，大量杀死	古罗马对反叛军团的一种惩罚，每十个人抽杀一个，后泛指大屠杀
deleterious	有害的	清除（delete）有害物质
covet	妄想	一手遮天（covert）纯粹妄想（covet）
consummate	完全的，完成	
contagious	有传染性的	
contrive	计划，设计	
copious	多产的，丰富的	
corroborate	支持，证实	
coterie	（有共同兴趣的）小团体	
countenance	支持；表情	
counterproductive	事与愿违的	
courteous	有礼貌的	
crater	火山口，弹坑	
crimson	绯红色（的）	
cringe	畏缩，谄媚	
crumple	起皱	
cursory	草率的，粗略的	
curt	（言辞、行为）简略而草率	
curtail	削减，缩短	
custodian	监护人，管理员	
damp	减弱，抑制；潮湿的	
dappled	有斑点的，斑驳的	
daunt	使胆怯	
dearth	短缺	
debauch	使堕落	
decorous	高雅的，合宜的	
decorum	礼节	
decrepit	衰老的，破旧的	
decry	谴责	
defame	诽谤	
defecate	澄清，净化	
defer	延期；遵从	
defunct	死亡的	
deign	惠允，施惠于人	
dilatory	拖拉的，不慌不忙的	delay
dictate	口述	dict=say,declare
didactic	教诲的，说教的	did + act
disciple	信徒，弟子	disipline
dismal	沮丧的，阴沉的	dismay 沮丧，惊慌
diffident	缺乏自信的	fid=faith, trust
digress	离题	gress=walk,step, go
dilapidate	荒废，损坏	lapid=stone
dilate	使膨胀，使扩张	lat=broad, wide
denigrate	诽谤	nigr=black；negro 黑人
deplore	哀叹，谴责	plor=cry, weep
disposable	一次性的，可自由使用的	pos=posit=put
deprave	使堕落，使腐败	prav=crooked 弯曲的，不诚实的；deep into grave
deprecate	反对，轻视	prec=pray 祈祷，乞求；depreciate 轻视，贬值
deride	嘲弄	rid=laugh
derogate	损毁，贬损，诽谤；背弃	rog=ask
desecrate	玷污	secr=sacr=holy
dissect	解剖，剖析	sect 宗派，教派；作为词根 sect=cut，各教派彼此分割，各自为政
dissident	唱反调者	sid=sed=sit
disperse	消散，驱散	spers=scatter
despicable	卑鄙的	spic=look
despondent	失望的，消沉的	spond=promise
desultory	不连贯的，散漫的	sult=leap
detest	厌恶，憎恨	test=witness
detriment	损害	tri=trit=rud摩擦
deviate	越轨，偏离	via=way
devious	不坦诚的，弯曲的	vio=via=way
devoid	空的，缺乏的	void=empty
diehard	顽固分子	死（die）硬（hard）分子
disenfranchise	剥夺权利	源于法语，franchise 公民权，特权
delimit	界限	
delineate	描述，勾画	
deluge	洪水，暴雨	
demean	贬抑，降低	
demobilize	遣散	
demolish	破坏	
demotic	民众的，通俗的	
demur	异议，反对	
demure	（女子）端庄、娴静	
derelict	荒废的，疏忽的，不忠的；被遗弃物或流浪汉	
descry	看见，觉察	
deter	威慑，阻止	
devour	吞食，贪婪地看或听等	
devout	虔诚的，忠心的	
dilettante	一知半解的人，业余爱好者	
disabuse	打消错误念头，使醒悟	
disavowal	否认	
discern	辨别，洞悉，目睹，认识	
discharge	流出，释放，解雇，履行义务	
discourse	演讲，论述	
discreet	谨慎的	
discretion	谨慎	
discursive	散漫的，不得要领的	
disgruntled	不悦的	
disinclination	不情愿	
disingenuous	不坦率的	
disinterested	公正的，客观的	
disjunctive	分离的，转折的	
dismiss	解散，解雇	
disparage	轻蔑	
disparate	迥然不同的	
dispassionate	平心静气的	
disprove	证明有误	
disrupt	使混乱、中断	
disseminate	传播，宣传	
dissipate	使消失、消散	
distent	膨胀的，扩张的	
distraught	心烦意乱的，狂乱的	
embellish	装饰，美化	bell=fine
embroider	刺绣，装饰	broid=braid=twist
diurnal	白天的	di=day
dogged	顽强的	dog 倔强，坚强
docile	驯服的，听话的	dog 忠诚，听话
dorsal	背部的	dors=dos=back
endorse	赞同，背书	dors=dos=back
dossier	卷宗，档案	dos=dors=back 背面前有标签的文件
eclectic	折中的，兼容并蓄的	lect=leg=read, gather；ec=out
elucidate	阐明	luc=bright,light
elude	躲避，理解不了或抓不到	lud=lus=play
elusive	难懂的	lud=lus=play
epitome	典型，梗概	tom=cut，切除外部（epi）无关紧要的东西
divulge	泄露	vulg=crowd
elegiac	哀歌（的），挽歌	音：哀历假
drowsy	犯困的	音：堕睡 身体下堕睡着了
enthrall	迷惑，迷住	音：银丝绕心头
dogma	教条	
down	绒毛	
downplay	贬低，不予重视	
drab	单调的，黄褐色的	
droll	好笑的，滑稽的；小丑，闹剧	
drone	单调的声音	
drudgery	苦工	
dubious	可疑的，靠不住的	
ductile	易延展的，可塑的	
dumbfound	哑然失声，吃惊	
dupe	易骗的	
duplicity	欺骗	
dwindle	减小	
edifice	宏伟的建筑	
edify	陶冶，启发	
efface	擦抹掉	
effervesce	冒泡，沸腾，兴奋	
effete	无生产力的，虚弱的	
efficacy	有效性，功效	
egregious	极端恶劣的	
elate	使愉快	
elicit	引出	
embezzle	挪用，盗用	
emblem	象征	
emulate	竞争，模仿，仿真	
enamored	倾心的	
encroach	侵占，蚕食	
encumber	妨碍	
endear	使受喜爱	
endemic	地方性的	
endow	赠予，给予	
enervate	使虚弱	
engender	引起，产生	
engrave	铭刻，铭记	
enigma	谜一样的人或事物	
entice	引诱	
entrenched	（权利、传统）确立的，牢固的	
ephemeral	朝生暮死的，生命短暂的	
epic	史诗（的），大规模的	
episodic	偶然发生的，分散的	
exasperate	激怒	asper=rough
excavate	开凿，挖掘	cav=hole,hollow
excise	切除	cis=cid=cut, kill
equivocal	模棱两可的	equ=equal； voc=voice
erratic	不稳定的，无规律的，古怪的	err=stray 迷路，偏离
ethereal	太空的，轻巧的	ether 大气，苍天；以太网 ethernet
eulogistic	颂扬的	eu=well,good；log=thought,word,speech
euphemism	委婉的说法	eu=well,good；phem=speech
euphonious	悦耳的	eu=well,good；phon=sound
euphoric	欢欣的	eu=well,good；phor=bear,carry
exonerate	免除责任或处罚	ex + onerous
exorbitant	过分的	ex + orbit
extant	现有的	exist
feckless	无效的，不负责任的	feck 价值，效能
ferocity	凶残	feroc=fierce
ferromagnetic	磁铁的	ferr=iron
fervent	热情的，炽热的	ferv=boil,glow 发热，发光
fervid	热情的，炽热的	ferv=boil,glow 发热，发光
fervor	热烈	ferv=boil,glow 发热，发光
festive	欢宴的，节日的	festival 节日
fetid	有恶臭的	fet=stink
figment	虚构的事	fig=fict=form,shape
exhilarate	使兴奋，使振作，鼓舞	hilar=glad
expeditious	敏捷的，迅速的	ped=feet，健步如飞
exposition	阐释，展览会	pos=posit=put
exquisite	精致的	quisit=search,seek 精挑细选之意
evade	逃避	vad=vas=go
evanescent	短暂的，易消失的	van=empty,vain,idle
evasive	逃避的	vas=vad=go
eviscerate	除去主要部分，挖出内脏	viscer=internal organ
espouse	支持	配偶（spouse）之间彼此支持
extricate	摆脱，脱离，拯救	使用计谋（trick）脱逃
fecund	肥沃的，创造力旺盛的	音：肥康，肥沃健康，有创造力
equestrian	骑马的，骑士阶层的	
equitable	公正的，合理的	
erudite	博学的	
escalate	（战争等）升级	
eschew	避开	
esoteric	机密的	
estrange	使疏远	
ethos	风貌，气质	
evince	表明	
exalted	崇高的	
exert	运用，施加	
exhaustiveness	全面的，彻底的	
exigency	紧急需求	
exorcise	驱除魔鬼或坏念头	
expediency	方便，权宜之计	
expressly	清楚地，特意地	
extol	赞美	
extraneous	外来的，无关的	
extrapolate	推测，外推(数学)	
exuberant	（人）充满活力的，（植物）茂盛的	
facetious	滑稽的	
facile	易做到的，肤浅的	
faddish	时尚的	
fallow	休耕（的）	
falter	（行动）蹒跚，（言语）支吾	
farce	闹剧，荒诞的行为或事物	
fastidious	挑剔的	
feign	假装	
ferment	发酵，使激动	
fickle	(感情）易变	
gospel	教义，信条	“流言（gossip）止于智者”应当成为网络人的一个重要信条（gospel）
forebode	预感，预兆	bode 预示，预兆
forfeit	丧失，被罚没；丧失的东西	feit=do,make
floral	花的，植物的	flor=flower
florid	华丽的，（脸）红润的	flor=flower
foliage	叶子	foli=leaf
folly	愚蠢（的想法或做法）	fool-ly
forlorn	孤独的	for + lone
fortuitous	偶然的	fortune
fractious	易怒的	fract=break
frail	脆弱的	fragile
fraternity	友爱，同行	frater=brother
fumigate	烟熏消毒	fum=smoke
furtive	秘密的	furt=steal
gainsay	否定	gain=against
garrulous	唠叨的	garr=chatter 絮絮叨叨
glutinous	粘的，胶状的	glutin=glue
grandiloquence	豪言壮语，夸海口	grand=huge；gran=grain 颗粒
gratuitous	无故的，免费的	grat=thank 表示感激的费用
gregarious	群居的，合群的	greg=flock,herd
grate	磨碎，使人烦躁，刺激	老鼠格拉格拉地咬木柜，心烦地恨不得杀了它
gallant	勇敢的，（对女人）殷勤的	有胆（gall）
finicky	苛求的，过分讲究的	
flabby	松弛的，意志薄弱的	
flagrant	罪恶昭彰的，公然的	
flake	使成薄片	
flamboyant	艳丽的，炫耀的	
flaunt	炫耀	
flickering	闪耀的，忽隐忽现的	
flimsy	轻而薄的，易损坏的	
flip	轻弹；无礼的，轻率的	
flock	兽群	
flounder	挣扎，艰苦移动；比目鱼	
flout	蔑视，违抗	
fluffy	有绒毛的；无聊的，琐碎的	
fluorescent	荧光的，发光的	
flustered	慌张的	
foible	小缺点	
foreshadow	成为先兆，预示	
forestall	预先阻止，先发制人	
formidable	可怕的，难以克服的	
forsake	放弃	
forte	长处	
forthright	直率的	
founder	（船）沉没，（计划）失败	
fraught	充满的	
fray	吵架，磨破	
frenetic	狂乱的	
fret	烦躁，焦虑	
friend	赞助人	
fussy	挑剔的	
gall	胆汁，怨恨	
galvanize	刺激，电镀，通电	
garble	曲解，篡改	
garish	艳丽的	
gaudy	艳丽的	
genial	和蔼的	
gibe	讥讽	
giddy	轻浮的	
glandular	腺（状）的	
glaze	上釉，使光滑	
gloat	幸灾乐祸地看	
glossy	光滑的	
glucose	葡萄糖	
gluttonous	贪食的	
gouge	挖出，敲竹杠	
graft	嫁接，贪污	
graze	吃草，放牧	
guile	欺骗，狡猾	guileless 厚道的，老实的
haphazard	偶然的，随意的，杂乱的	happened
harass	烦扰	hare 兔子， 兔子（hare）不吃窝边草（grass），自然不会烦扰它们
haughty	傲慢的	haugh(=high)
hearten	鼓励	heart-en
heartfelt	衷心的	heart-felt
hedonist	享乐主义者	hedo=pleasure
heinous	可憎的	hein=odious
hereditary	祖传的，世袭的，遗传的	her=heir
herbaceous	草本的	herb=grass
heterodox	异端的	heter=different,other
hieroglyph	象形文字，神秘符号	hier=holy；glyph 象形文字
hilarity	狂欢	hilar=glad
histronic	做作的，戏剧的	histri=actor
homogenize	使均匀	hom=same；homogeneous
homespun	朴素的，家纺的	home-spun(spin过去式， 纺织）
hypochondriac	患忧郁症的；忧郁症患者	hyp=under，chondr=cartilage 软骨
hyperbole	夸张法	hyper=above,over
hypnotic	催眠的；催眠药	hypn=sleep
iconoclasm	破坏偶像的理论，打破旧习	icon=image，clas=clast=broken
idiomatic	惯用的，符合语言习惯的	idio=peculiar, private
idiosyncracy	特质	idio=peculiar,private；syn=with；cracy=government,rule,authority
idyllic	田园诗的	idyl 田园诗
ignoble	卑鄙的，卑贱的	ig=not
igneous	似火的，火的	ign=fire
illicit	违法的	il-D496licit
impermeable	不可渗透的	im + permeable
imperative	紧急的	imper=emper=command
imperious	傲慢的，蛮横的	imper=emper=command
immaculate	无瑕的	maculate 有斑点的，玷污
imminent	即将发生的	min=jut 突出
ignominy	可耻的	nomin=name, reputation；ig=not
impecunious	没钱的	pecuni=money
impede	妨碍	ped=foot
impertinent	无关的；无礼的	pertain 关于，涉及，合适，相称
grope	摸索	摸着绳索（rope）寻找，按图索骥
haggle	讨价还价	音：海购
hackneyed	陈腐的	英国伦敦哈克尼（Hackney）以育马闻名，旧时对此行当存在偏见，认为他们低贱
humdrum	单调的	源于hum
grim	冷酷的，可怕的	
grind	磨碎的；苦差	
gripping	扣人心弦的	
grudge	吝啬；妒忌，怨恨	
grumble	抱怨	
gull	欺骗	
gush	涌出，滔滔不绝地说	
hale	健壮的，矍铄的	
hallow	尊敬，敬畏	
hardheaded	冷静的，精明的	
headstrong	刚愎自用的	
heretical	异端的	
hiatus	空隙，裂缝	
hive	蜂巢	
huckster	叫卖小贩，零售商	
hunch	直觉，预感	
hurl	猛掷，大骂	
imbue	浸透，灌输，激发	
impassable	无法通过的	
impassioned	充满激情的	
impassive	冷漠的	
impeccable	无瑕的	
impersonal	非个人的，不具人格的，冷淡的，客观的	
impersonate	扮演	
imperturbable	沉着的	
inadvertent	疏忽的，无心的	advertent 注意；不注意=疏忽
incarnate	化身的，拟人化的	carn=flesh
incessant	不停的	cess=go
incise	切割，切入	cis=cid=cut, kill
incisive	尖锐的，深刻的	cis=cid=cut, kill
incorrigible	不可救药的，积习难改的	corrigi(=correct)
incredulity	不相信，怀疑	cred=believe, trust
indent	切割成锯齿状	dent 凹痕，凹槽
indenture	以契约约束；契约	dent 凹痕，凹槽 契约一式两份，相接凹槽可用作比对，以确保无误
indict	控诉	dict=say,declare
indignation	愤怒	dign=nobel
indubitable	无疑的	dub=doubtful
inexorable	不为所动的	exorable 可说服的，心软的
inexplicable	无法解释的	explicable 可以解释的
indefatigable	不知疲倦的	fatigue 疲劳，疲倦
infiltrate	渗透	filter
impetuous	鲁莽的	impetus
incipient	初期的	inception
infamous	臭名昭著的	infamize 使声名狼藉
ingenuous	纯朴的，坦率的	ingenious
impervious	不可渗透的，不为所动的	per=through；vio(=via)=way
imponderable	无法衡量的	ponder=weight
impudent	无礼的	pude=shame
impugn	异议，怀疑	pugn=fight
impunity	免受惩罚	pun=pen=penalty；im=not
impute	归咎于	put=reckon
imprudent	不理智的	贬义，原本prude具有各种优良的品质：聪明、勇敢、正直
impiety	不虔诚的，无信仰的	
impolitic	不明智的，失策的	
imposing	印象深刻的，壮观的	
impostor	骗子	
impound	限制，没收，扣押	
impromptu	即席的	
improvident	无远见的，不节俭的	
improvise	即席创作	
inalienable	无法转让的，不可剥夺的	
inane	空洞的	
incendiary	纵火的	
incense	激怒；香味	
incoherent	不连贯的	
incommensurate	不相称的	
inconsequential	不重要的	
inconsolable	无法慰藉的	
incumbent	现任者	
indebted	感激的，蒙恩的	
indigence	贫困	
indigenous	本地的，固有的	
indolent	懒惰的	
infest	骚扰，寄生于	
infuse	灌输，鼓励	
ingrain	根深蒂固的，木质	
inimical	怀有敌意的	enemy
ingratiating	讨好的，献媚的	grat=thank
inimitable	无法效仿的	imitable 可模仿的，值得模范的
irascible	易怒的	irasc=irat=be angry
iridescent	色彩斑斓的	irid(=iris 虹光）
itinerant	巡回的，旅行线路的	itiner=journey
jocular	滑稽的，幽默的	joc=joke
jubilant	欢呼的	jubil=short of joy
judicious	有判断力的，审慎的	jud=judge
juncture	危急关头，结合处	junct=join
inordinate	过度的	ordin=order
inquisitive	好奇的，好问的	quisit=search,seek 精挑细选之意
irradiate	照射	radi=beam
irradicable	无法根除的，根深蒂固的	radic=root
irreverent	不尊敬的	rever=awe 敬畏
interrogation	质问，审问；疑问句	rog=ask
insinuate	暗指	sinuate 弯弯曲曲的，波状的
irresolute	犹豫不决的	solut=solv=loosen,set free
insurgent	叛乱的；叛乱分子	surg=rise
intemperance	放纵，过度	temperance 节制，克制；稳健
interminable	无止境的	termin=boundary,limit,end
intrepid	勇敢的	trepid 胆小的
invigorate	鼓舞，使精力充沛	vigor 精力，活力
inviolate	不受侵犯的，未受损害的	violate 违反，冒犯，障碍
insolent	粗野的，无礼的	老子是唯一的（sole）
jumble	使混乱	心跳（jump）加速
insipid	乏味的	
instigate	鼓动，煽动	
intransigent	不妥协的	
intrigue	密谋；引起兴趣	
irredeemable	无法挽回的，不可救药的	
irreparable	无法挽回的，无法弥补的	
irreproachable	无可指责的，完美的	
jaded	疲惫的，厌倦的	
jest	开玩笑；笑话	
jolting	令人震惊的	
noisome	恶臭的，令人讨厌的	annoy
misanthrope	厌恶人类者	anthrop=human
obdurate	顽固的	dur=hard； endure
obfuscate	使困惑，使迷惑	fusc=dark
misogyny	厌恶女人	gyn=woman
obliterate	涂掉，删除	liter=letter；ob=obove 在字母上面涂画
mischievous	淘气的，有害的	mischief
mollify	抚慰，安抚；使缓和、减轻	moll=soft
monumental	极大的；纪念碑的	monument 纪念碑
moralistic	道学的，说教的	morale 士气，道德；moral 道德(的)
morbid	病态的，不健康的	morb=disease
mordant	讥讽的，尖酸的	mord=bite
mortify	使丢脸、侮辱	mort=death，死的心都有了
mundane	现世的，世俗的，平凡的	mund=word
mural	墙壁的；壁画	mur=wall
murk	黑暗的，朦胧的	mur=wall
myriad	许多的，无数的	myri=countless
narcotic	麻醉的，催眠的；麻醉剂	narc=numb
nebulous	模糊的，云状的	neb=cloud
nocturnal	夜晚的	noct=night
nonplussed	不知所措的，陷入困境的	nonplus 迷惑，困惑；数学课本没有加法（plus），怎么搞
nostalgia	思乡，怀旧之情	nost=home；alg=pain
odious	可憎的	odi=hate；odium 可憎的
omnipotent	全能的	omni=all
misapprehension	误会，误解	prehens=prehend=grasp
obsequious	逢迎的，谄媚的	sequ=follow
observant	警惕的，敏锐的，遵从的	serv=save, protect, serve
obsolescent	荒废的	sol=alone,only
misconstrue	误解，曲解	stru=struc=build, make up
obstruct	阻塞（道路，通道等），妨碍	stru=struc=build, make up
obviate	消除（困难，危险等）	via=way
obstinacy	固执，倔强	不（ob）达目标（destinate）绝不罢休
nonviable	无法生存的，不能成活的	没有（non)出路（via）
morose	郁闷的	音：莫若死
misalliance	不适当的结合	
mit	微量，小螨虫	
mitigate	使缓和，使减轻	
momentous	重大的，极重要的	
moratorium	延缓偿付，活动中止	
motif	（文艺作品等）主题，主旨	
motley	混杂的，各色的	
muddle	迷惑，混乱	
munificent	慷慨的，丰厚的	
natty	整洁的，敏捷的	
nibble	一点点咬，慢慢啃	
nonchalance	冷漠	
noncommittal	态度暧昧的，不承担义务的	
notch	V形切口，刻痕，等级	
nubile	(女子)适婚的，性感的	
oblige	帮助，施惠于人	
oblique	倾斜的，简接的，不坦率的	
oblivious	忘却的，疏忽的	
officious	多管闲事的，非官方的	
perennial	全年的，持久的	enn=ann=year；per=thoroughly
parable	寓言	fable 寓言
perfervid	过于热心的	ferv=boil,glow 发热，发光
perfidious	不忠的	fid=faith,trust
perfume	香味，香水	fum=smoke
perfunctory	例行公事的，敷衍的	funct=do
ossify	骨化，僵化	oss=bone
ostentation	炫耀	ostensible 表面的
ostracize	排斥，放逐	ostrac=shell 古希腊使用贝壳投票决定是否驱逐某人
palpable	可触知的，明显的	palp=feel
pantomime	哑剧	panto=all, mime 模仿，笑剧
paraphrase	释义，改写	para=beside,near 短语（phrase）旁作注
parsimony	吝啬，过分节俭	pars=spare,save
partisan	党羽	party
pathological	病态的，不理智的，病理学的	path=feeling,disease；log=logy=word,speech,thought
patronize	资助，惠顾	patr=father
patronizing	以施舍态度对人，显示优越感的	patr=father
patriarchal	家长的，父权制的	patr=father；arch=ruler
paucity	少量，缺乏	pauc=few
pecuniary	金钱的	pecuni=money
pedagogic	教育学的	ped=foot,education；agog=lead
pejorative	变坏的，轻蔑的	pejor=worse；pejorate 变坏，恶化
penitent	悔过的，忏悔的	pen=punish 惩罚以后开始后悔
permeable	可渗透的	per=through；me=go
permeate	扩散，穿透	per=through；me=go
peripatetic	巡游的，流动的	peri=around；pat=to walk
peripheral	周边的，外围的	peri=around；pher=bear,carry
perpetrate	犯罪，负责	petr=rock
perquisite	津贴，小费	quisit=search,seek 精挑细选之意
override	驳回，蹂躏	rid=laugh
paltry	无价值的，微不足道的	白白（pal=pale）努力（try）
ordeal	严峻的考验	音：恶地儿 太TM考验人了
parody	拙劣的模仿（表演或作品）	音：帕罗蒂 模仿帕瓦罗蒂，不啻于东施效颦
peeve	使气恼，怨恨	音：屁喔 狗屁哦
paragon	模范	源于意大利语“测试黄金的试金石”；音：配罗庚 与华罗庚相当的人才
opalescent	发乳白色光的	
opinionated	固执己见的	
opportune	合适的	
opprobrious	侮辱的，辱骂的	
opulent	充足的，富裕的	
oust	驱逐	
outgoing	友善的，即将离去的	
outgrowth	结果，副产品	
outlying	偏僻的	
outmoded	过时的	
outspoken	坦率的	
outstrip	超越	
overcast	阴天的，阴暗的	
overdraw	透支，夸大	
overdue	到期未付的，延误的	
overrule	驳回，否决	
overstate	言过其实，夸大	
overwrought	紧张或兴奋过度的	
paean	赞美词，颂词	
painstaking	专注地，辛苦地	
palatable	美味的	
pancreas	胰腺	
pedant	学究，迂腐之人	
peerless	无可匹敌的	
penchant	嗜好	
pernicious	有害的，致命的	
precipitate	突然降临，促成；轻率的	cipit=capit=head
precipitous	陡峭的	cipit=capit=head
proclivity	倾向	cliv=clin=lean, slop
preclude	预防，排除；阻止	clud=close,shut
procure	得到	cur=cura=care for
prefabricate	预制	fabricate 虚构，制作
piety	孝顺，虔诚	filial peity子女孝顺
premonition	预感，预兆	mon=warn
pestilential	引发瘟疫的，致命的，极讨厌的	pest 害虫， 黑压压袭来
petulant	暴躁的，易怒的	pet 宠物，宠坏的孩子，不悦，生气
phobia	恐惧症	phob=fear
phonetic	语音的	phon=sound
placate	抚慰，平息	plac=please
placebo	镇静剂	plac=please
plaintive	悲伤的	plaint 抱怨，诉苦，抗议
plethora	过多，过剩	pleth=full
ponderous	笨重的	ponder=weight
potted	盆栽的，瓶罐装的	pot 罐，壶
pottery	制陶，陶器	pot 罐，壶
potable	适于饮用的	pot=drink
presumptuous	放肆的，过分的	presume 假设，假定，冒昧
pretentious	炫耀的，自命不凡的，狂妄的	pretentious 自命不凡的，做作的，夸耀的
preternatural	超自然的，异常的	preter=past
probity	正直	prob=worthy, good
prerogative	特权	rog=ask
prescient	有先见的	sci=know
perspicacious	敏锐的	spic=look
perspicuous	明晰的	spic=look
perspire	出汗	spir=breathe
platitude	陈词滥调	平淡（plat）无奇的论调
phlegmatic	冷漠的，不易动感情的	西方古代哲学：粘液质（phlegm）的人不易动感情
philistine	庸俗的人	源于腓力斯人（Philistine）
potshot	肆意抨击；盲目射击	源于猎人为食饭（pot）而随意射击
pertinent	相关的，有关的	
pinpoint	精准的，准确确定，突出引起注意	
pious	虔诚的	
pitcher	带柄水罐	
pithy	精髓的，简练的	
plainspoken	直言不讳的	
pliable	柔软的，易受影响的	
plumb	垂直的；精确地；深入了解，测量深度；铅锤	
plump	丰满的；使变圆	
plunge	跳进，陷入，俯冲	
poignant	痛苦的，尖锐的	
poise	使平衡，泰然自若	
pollen	花粉	
pollinate	授粉	
pomposity	自大	
pompous	自大的	
pop	（声）砰	
portend	预兆，预示，凶兆	
possessed	入迷的	
postulate	假定，要求	
pounce	突袭；（猛禽的）爪	
precarious	未证实的，不稳固的，危险的	
predispose	倾向于；易受感染的	
preempt	以优先权获得；取代	
premise	前提	
preoccupation	专注；使人专注的东西	
prig	自命清高者，道学先生	
recalcitrant	顽固的	calc=stone
recapitulate	概要重述，总结	capit=head
recessive	隐形遗传的，后退的	cess=move,go
recluse	归隐的	clus=clud=close,shut
profligacy	放荡，肆意挥霍	flig=strike down
profuse	丰富的；浪费的	fus=pour
promulgate	颁布（法令），宣传	mulg=milk
propensity	习性	pens=pend=hang
purported	传说的，传言的	port=carry 被（-ed)人带出去的
purport	内涵，主旨	port=carry 自己所传达的
profundity	深奥的事物；深刻	profound
prosaic	散文（体）的；单调的	prose
protozoan	原生动物	prot=first；zo=animal,living being
pugnacious	好斗的	pugn=fight
quagmire	沼泽地；困境	quag=mire 沼泽
rampant	猖獗的，蔓生的	ramp（斜坡，狂跳乱撞)
rancid	变馊的，不新鲜的	ranc=sting,bitterness,resent
rancor	仇恨	ranc=sting,bitterness,resent
ratify	批准	rat=calculate
rationale	基本原理	rat=calculate
ravage	摧毁，使荒废	rav=rapt=rap=snatch 捕，夺
rave	热烈赞扬；胡言乱语	rav=rapt=rap=snatch 捕，夺
raze	夷为平地	raz=ras=rad=scrapt 刮，擦
reactionary	极端保守的；反动的	react 反作用，反抗
recuperate	恢复	recover
proscribe	禁止	scrib=script=write
protract	延长	tract=draw,pull
protrude	伸出	trud=thrust 延伸
prudish	过分守礼的	贬义，原本prude具有各种优良的品质：聪明、勇敢、正直
queruous	抱怨的，牢骚的	查询（query）时有各种疑问，甚至抱怨
qualm	恐惧，不安	咕噜把戒指捧在手心（palms）生怕丢了
quixotic	空想的，不切实际的	唐-吉可德（Don Quixote）
ragtime	滑稽的；格雷厄姆音乐	以搞笑为特征的格雷厄姆音乐
proselytize	使皈依	音：普罗舍利
reconnaissance	侦查，预先勘测	源于法语，to recognize
quarantine	隔离	字面意思：四十天，威尼斯创建了世界上第一个检疫站，隔离期一般定为40天
prodigal	挥霍的；挥霍者	
prodigious	巨大的；奇异的	
propitiate	讨好；抚慰	
propitious	顺利的，有利的	
prostrate	悲痛的，平卧的	
provident	远见的；节俭的	
provisional	暂时的	
pungent	辛辣的，刺激的，尖锐的	
purchase	支点	
quaint	离奇有趣的，古朴典雅的	
quash	镇压，取消	
raisin	葡萄干	
ramshackle	摇摇欲坠的	
ranching	大牧场	
raucous	刺耳的，沙哑的，喧嚣的	
rebuke	谴责	
reckless	鲁莽的	
reclaim	纠正，改造；开垦（土地）	
recoil	反弹；退缩	
recondite	深奥的，晦涩的	
recount	叙述，描写	
recourse	求助，依靠	
redeem	弥补，赎回，偿还	
retribution	报应，惩罚	aginst + contribution
refractory	倔强的；（疾病）难以治愈的	fract=break
regressive	退化的	gress=go,walk
reimburse	偿还	imburse = im（in) + burse (钱包，国库) = 偿还，资助
reinstate	恢复	instate 任命
remiss	疏忽的，倦怠的，玩忽职守	miss 疏忽
remunerative	有报酬的，有利润的	muner=gift
replenish	充满，补充	plen=full
replete	充满的	plet=fill
reprehend	谴责，责难	prehend=grasp
repugn	反对，反抗	pugn=fight；re=against
repugnant	让人反感的、厌恶的	pugn=fight；re=against
resurrect	复活，复兴	rect=stright
reparable	可补救的	repair
reprimand	训诫，谴责	repr-imand
reprisal	报复	repr-isal
reproach	谴责	repr-oach
respite	休息，暂缓	rest
revere	尊敬	rever=awe 敬畏
reverberate	回声，回响；击退	rever=awe 敬畏；berate 申斥，斥责
regiment	团；组团，管辖	rig=reg=to rule
roseate	玫瑰色的，过分乐观的	rose
restitution	归还，赔偿	stitut=statut=set up, place
resurge	复活	surg=rise
retentive	保持的，保留的，记忆力强的	tent=hold
reticent	沉默寡言的	tic=be silent
revoke	撤销，废除，召回	vok=voc=call,voice
renegade	叛徒，叛教者，变节者	回过头（re)就否认（neg)
restive	不平静的，不安宁的	奇葩的词
regale	款待，使快乐	
rehabilitate	恢复	
relegate	降级；交付	
relent	宽厚，怜悯，减弱	
relish	美味，兴趣，享受	
remorse	懊悔	
repeal	废除（法律）	
repellent	惹人厌恶的	
repudiate	拒绝接受，抛弃	
repulse	击退，拒绝	
repute	认为；名誉	
rescind	废除，取消	
resuscitate	复活，苏醒	
retaliate	报复	
revile	辱骂	
rhapsodic	狂热的，狂想曲的	
rift	断裂，矛盾	
rip	撕裂	
rivet	凝神；固定	
seclude	隔离，孤立	clud=close,shut
seductive	诱人的	duct=lead；inductive
scrappy	碎片的，好斗的，坚毅的	rap=rad=ras=raz=scrape‘刮擦’
rudimentary	初步的	rud=rough, unformed；rude 原始，粗野
ruminant	（动物）反刍的，沉思的	rumin=throat 喉咙
saline	含盐的	salt
salubrious	有益健康的	salu=health
salutary	有益健康的	salu=health
sanctimonious	假装虔诚的	sanc=holy
sanctuary	圣所，避难所	sanc=holy
sanctum	圣所	sanc=holy
sanguine	乐观的，红润的	sanguin=blood
schism	教会分裂	schis=split
segregate	隔离，分离	se=apart, greg=flock,herb
sequester	隐蔽的；使隐退；扣押，没收	se=apart, quest=seek,search
sectarianism	教派意识	sect 宗派，教派；作为词根 sect=cut，各教派彼此分割，各自为政
sedate	镇静的	sed=settle, calm
sedimentary	沉积的	sed=settle, calm
sedentary	久坐的	sed=sit
sedulous	勤勉的	sed=sit
sentimentalize	使感伤	senti=feel；ment=mind
septic	腐败的	sept=to rot
slipshod	马虎的，邋遢的	slapdash 草率的，粗心的
slavish	卑屈的，效仿的，无创造性的	slav=slave
slippery	滑溜的	slip
skinflint	吝啬鬼	打火石（flint）每次只用一点点（skin）
serendipity	意外发现新奇事物的能力或现象	英国作家Horace Walpole造的一个词，源于其小说《斯里兰卡三王子》（The Three Princes of Serendip）。锡兰（Serendip）系斯里兰卡旧称，三个王子总能意外发现一些宝物。
servile	奴性的	源于slave
sinuous	弯曲的	正弦曲线（sin）的图像弯弯曲曲
slander	诽谤，诋毁	制造丑闻（scandal）达到诋毁人的目的
rowdy	吵闹的，粗暴的	
rueful	遗憾的，后悔的	
rugged	高低不平的，崎岖的	
rustic	乡村的，乡土的	
sabotage	阴谋破坏、颠覆	
sage	智慧的；智者	
salient	显著的	
sap	削弱，耗尽；树液	
saturate	浸透，使饱和	
saturine	忧郁的，阴沉的	
scant	不足的	
scavenge	清除，从废物中提取有用物质	
scorn	轻蔑	
scour	四处搜索，擦掉	
scourge	鞭笞，磨难	
scramble	攀登，搅乱，争夺	
scruple	迟疑，顾忌；微量，吩（药剂单位）	
scrupulous	恪守道德规范的，一丝不苟的	
secular	世俗的，长久的	
seismic	地震的	
self-adulation	自我吹捧的	
self-effacement	自谦	
self-righteousness	自以为是	
seminal	有创意的	
serene	平静的，明朗的	
serrated	锯齿状的	
shed	流出（眼泪等）；脱落	
shiftless	无能的，懒惰的	
shoal	浅的，薄的；浅滩	
shrivel	（使）枯萎	
shun	避免，闪避	
shunt	改变方向	
skimp	吝啬	
slash	大量削减	
slimy	粘滑的	
sloven	懒散的人，散漫的人	
smother	熄灭，覆盖，窒息	
smug	自满的	
snub	冷落	
supercilious	傲慢的	cili=eyelash 睫毛
solicit	恳求，教唆	cit=call,start；sol=total
solicitous	热切的，挂念的	cit=call,start；sol=total
sterile	贫瘠的，不育的，无菌的	fertile 肥沃的，能繁殖的，富饶的
supersede	淘汰，取代	sed=sit
subservient	从属的，有用的，恭顺的	serv=save, protect, serve
subside	下陷，平息，减退	sid=sed=settle
subsist	生存，维持生活；存在，居住	sist=stand
somber	忧郁的，阴暗的	sober 清醒的
solitary	孤独的；隐士	sol=alone,only
soliloquy	自言自语，戏剧独白	sol=alone,only；loqu=speak
solvent	有偿债能力的；溶剂	solv=loosen, set free
sonorous	洪亮的	son=sound
sophomoric	一知半解的	soph=wise；一年级小白，二年级一知半解
sordid	卑鄙的，肮脏的	sord=dirt
specious	似是而非的，华而不实的	spec=look
specter	鬼怪，凶兆；缭绕心头的恐惧	spect=watch,look at
spinning	旋转的	spin 旋转；纺纱
squalid	污秽的，肮脏的	squal=dirty, filthy
stasis	停滞	state
stellar	星（球）的	stell=star
stilted	不自然的，夸张的	stiff
stratagem	谋略，策略	strategy
strenuous	奋发的，热烈的	strength 要变强壮，就得奋发图强
sultry	闷热的，风骚的	sult=leap；音：烧炊 烧火做炊事很热；骚唇 风骚放荡
superannuate	退休，过时	super=above, ann=year
subterranean	地下的	terr=earth
subvert	颠覆，破坏	vert=vers=turn
stoic	隐忍之人	斯多葛派(Stoic）为芝诺（Zeno）创立于约公元前380年，认为人不应为情感所动，应把各种事情当作神意或自然法则的不可避免的结果来坦然地接受
sully	玷污	源于soli， 莎丽掉进沙里
snug	温暖舒适的	
sobriety	节制，庄重	
solder	焊接	
solicitude	关怀，牵挂	
soporific	催眠的，安眠的	
spank	前进，飞跑，大屁股，拍击	
sparing	节俭的	
spongy	松软的	
sporadic	不定时发生的	
sprawl	散乱地展开；四肢张开地坐、卧	
spruce	整洁的；云杉	
spurious	伪造的	
spurn	拒绝，摒弃	
squander	挥霍	
squirt	喷出，溅入	
stalk	隐伏跟踪（猎物）	
stalwart	健壮的，坚定的	
stark	荒凉的，僵硬的，完全的	
stash	藏匿	
stately	庄严的，堂皇的，宏伟的	
steadfast	忠实的，不变的	
stem	阻止，遏制；茎叶	
stint	节省，节制	
stipulate	约定，规定	
stocky	矮壮的，粗壮的	
stodgy	乏味的	
stout	肥胖的，强壮的	
stratify	层化	
streak	加线条；条纹	
stringent	（规定）严格的，苛刻的	
stronghold	要塞，堡垒	
stumble	绊倒	
stymie	妨碍，阻挠	
subdue	征服，压制，减轻	
subdued	柔和的，温和的	
substantiate	使实体化，证实	
substantive	根本的，独立存在的	
succinct	简明的，简洁的	
succor	救助	
suffrage	选举权，投票权	
sumptuous	豪华的，奢侈的	
symbiosis	共生（关系）	bio=life；sym=with
synoptic	摘要的	opt=eye；syn=with
suspense	悬念，挂念	pens=pend=hang
sycophant	马屁精	phan=show
tranquil	平静的	qui=rest
surreptitious	偷偷的，秘密的	rept=crawl,creep
transcribe	抄写，转录	scrib=script=write
syllable	分成音节；音节	syl=with
synergic	协同作用的	syn=with
tacit	心照不宣的	tac=be silent
taciturn	沉默寡言的	tac=be silent
tactile	有触觉的	tact=tough
tantamount	同等的，相当于	tant=taut=same
tenable	站得住的，合理的	ten=hold
tenacious	坚韧的，顽强的	ten=hold
tendentious	偏见的	tendency
tenuous	纤细的，稀薄的，脆弱的，无力的	tenu=slender, thin
tepid	微温的，不热情的	tep=be warm；tepid=lukewarm
timeliness	及时，适时	timely 及时的，适时的
timorous	胆怯的	timid 胆怯的
topple	颠覆，推倒	top off 结束
torpid	懒散的，迟钝的	torpi(=torpe)=be numb
torpor	死气沉沉	torpo(=torpe)=be numb；音：头破，结果是反应迟钝，缝针都不用麻药
tortuous	曲折的，拐弯抹角的	tort=twist
transgress	冒犯，违背	trans=across, gress=go,walk
terse	简洁的，简明的	诗（verse）要简洁（terse）：terse verse
tenet	教义，信条	十（ten)戒是基督教徒一个重要的教义
tout	招徕顾客，极力赞扬	王婆大喊（out-cry）：卖瓜了卖瓜了，又香又甜啊
supple	柔软的，灵活的	音：撒泼 撒娇是一种软磨硬泡的手段，比较柔和、灵活
surly	脾气暴躁的，阴沉的	音：猞猁 一种野猫，像个深闺怨妇：脾气暴躁、阴沉
toady	谄媚者，马屁精	音：头地，领导面前“鸡吃米，头点地”
titular	名义的，有名无实的	有名（title）无实
tantalize	挑逗	源于希腊神话人物坦塔罗斯(Tantalus)，他因泄露天机受罚立于与下巴齐平的水中，口渴欲饮时水即流失；头上有果树，腹饥欲食时果子又消失
supplant	排挤，取代	
suppliant	恳求的；恳求者	
surmise	推测	
swamp	沼泽；使陷入困境，淹没	
swift	迅速的，敏捷的	
tact	机智，圆滑	
tapering	尖端细的	
tardy	延迟的，迟钝的	
tarnish	失去光泽	
taunt	嘲笑	
taut	绷紧的，拉紧的	
tawdry	华而不实的，俗丽的	
taxing	繁重的	
teem	充满，（雨水）倾注	
termite	白蚁	
tint	着色；色泽	
touchy	敏感的，易怒的	
trample	践踏	
unbridled	放纵的	bridle 笼头缰绳；束缚；ride 骑（马）
uncanny	(超自然）可怕的，神秘的，怪诞的	canny 谨慎的
unerringly	无过失地	err=stray 迷路，偏离
unfettered	自由的	fetter脚镣，源于feet
unimpeachable	无可指责的	impeach 指责，控告； peach 桃子，桃色，美丽的人，极好的，告发
uninitiated	外行的，缺乏经验的	initial 初期的，最初的
unleash	发泄，释放	leash （栓狗等）的皮带，皮条，束缚
translucent	（半）透明的	luc=lust=light, shine；trans=across
unpremeditated	无预谋的，非故意的	medit=ponder
unremitting	不间断的	mit=miss=send
unobtrusive	不引人注目的	obtrusive 突出的，爱管闲事儿的，多嘴的
unquestionable	毫无疑问的	questionable 可疑的
unquestioning	无异议的，不犹豫的	questioning 质问
trauma	创伤，外伤	traum=wound
treachery	叛逆，背信弃义,变节	treach(=trick 欺骗）
trespass	侵犯	tres=trans=across
tributary	支流的，进贡的；支流，进贡国	tribut=give
truculent	残暴的	truc=fierce
ulterior	较远的，将来的，隐秘的	ulter(=ultra=beyond)
ultimatum	最后通牒	ultim=farest；ultimate
umbrage	愤怒；树荫	umbr=shade, shadow
unctuous	油质的，油腔滑调的	Uncle的头上总是油亮油亮的，还常甜言蜜语，很会讨女人欢心
tricky	狡猾的	不好对付（trick）
unliterary	不咬文嚼字的，不矫揉造作的	不抠字眼儿
trite	陈腐的	礼仪（rite）存在的历史都很久，较为陈腐（trite）
tribulation	苦难	审判（trial）之后的负担（burden）：牢狱之苦，巨额罚金
trenchant	尖锐的	音：“唇枪”舌战，分外激烈精彩
tussle	争斗，争辩，扭打	源于tousle 混乱
underhanded	秘密的，狡诈的	源于于赌博手放到桌面下，可能产生作弊行为
transitory	短暂的	
tread	践踏，行走；步态，车轮胎面	
trepid	胆怯的，惊恐的，不安的	
truce	停战协定	
unarticulated	表达不清的	
unbecoming	不得体的，不合身的	
undemanding	不严格的	
undercut	削价抢生意	
understate	保守地说，轻描淡写地说	
unfailing	无穷的	
unmatched	无可匹敌的	
wary	谨慎的	aware
vindicate	辩白，辩护	dic(=dict)=say,speak,proclaim
wanderlust	漫游癖，旅游癖	lust 强烈的欲望
unreserved	不隐瞒的，坦白的	reserve 保留，说话不多
unscathed	未受伤害的，未受损伤的	scathe 损害，烧焦
unscented	无气味的	scent 气味
unscrupulous	肆无忌惮的	scrupulous 小心谨慎的
unseemly	不适宜的	seemly 适宜的
unstinting	慷慨的	stint 吝啬
unsubstantiated	未经证实的	substantiate 证实，确证
untenable	难以防守的，不能租赁的	tenable 站得住的，合理的；tent=hold
valorous	勇敢的	va(=war) + lor(=glory) 战争荣光属于勇敢之师
vainglory	自负，虚荣	vain(无价值的，自负的) + glory
vanity	自负，虚荣	van=empty,vain,idle
venerable	值得尊敬的，庄严的	vener=respectful
veracious	诚实的	ver=true
veracity	真实，诚实	ver=true
verdant	葱郁的，翠绿的	verd=green
vertebrate	脊椎动物的	vertebra 脊椎骨
vibrant	震动的，响亮的，充满生机的	vibr=swing
vicissitude	变迁，兴衰	vic=change
vilify	诽谤	vil=base
vindictive	报复的	vin(=ven)=hurt
virulence	恶意，毒性	vir=green；virus
viral	病毒性的	vir=grenn；virus
virtuoso	艺术大师	virtue so 德行修为极高的人
viscous	粘滞的，粘性的	visc=thick 厚且胶粘的
vitriolic	刻薄的	vitri=glass，引申“刻薄”
voluminous	长篇的，大量的	volume
vulgar	庸俗的	vulg=crowd
unwarranted	没有根据的	warrant 授权，正当理由，根据
unwieldy	难控制的，笨重的	wield 使用，挥舞，运用
unwitting	无意的，不知不觉的	wit 机智，智力
unworldly	非世俗的，精神上的	wordly 世俗的
wry	扭曲的，歪曲的，嘲弄的，讽刺的	wry=Y，扭曲的，Y形的
xenophobic	恐外的，恐惧外国人的	xeno=strange；phob=dislike,fear
unyielding	坚定的，不屈的，坚硬的	yielding 屈从的，柔顺的，易弯曲的
warp	弯曲	包裹（wrap）时发生弯曲（warp）
vestige	痕迹，遗迹	参考：investige，音：唯剩体骨 恐龙留下的痕迹只有体骨化石
vacillate	犹豫	参考：oscillate 震荡
veer	转向，改变（话题等）	参考：sheer
urbane	温文尔雅的	城市（urban）居民知识水平相对高，举手投足温文尔雅
venom	毒液，毒物，恶意	毒蛇（viper）的毒液（venom）
untold	无数的，数不清的	多的数不过来
voluble	健谈的，易旋转的	脑瓜转（volv）得快，十分健谈
vigilance	机警	危机时期，保持警惕
upstart	突然升官的人，暴发户	一炮冲天
wistful	惆怅的，渴望的	音：不得志“唯诗得赋”
venal	腐败的，唯利是图的	音：歪脑 动歪脑子索贿受贿
voyeur	窥阴癖者	音：望淫
vehement	猛烈的，热烈的	音：威猛
venial	（错误等）轻微的，可原谅的	音：微尼尔
vestigial	退化的	音：唯剩蹄夹，发生退化
wilt	枯萎	音：萎条
vogue	时尚	音：舞歌
voluptuous	撩人的，沉溺酒色的	音：舞露屁脱
valiant	勇敢的	勇敢的心：威廉（华莱士）
upstage	高傲的，骄傲的	站在高台上的法籍音乐指挥
vault	拱顶，地窖	
vent	发泄；孔，口	
vex	使烦恼，使恼怒	
vitiate	削弱，损害	
walrus	海象	
welter	混乱	
whittle	削减	
world-beater	举世无双的	
wrongheaded	执迷不悟的，固执的	
zenith	天顶，极点	
abdicate	退位，放弃	ab=away；dict=say,declare
abjure	发誓放弃	ab=away；jur=swear,law
abrogate	废除	ab=away；rog=ask
abject	卑鄙的，可怜的	ab=from；ject=cast,throw
agog	兴奋的	agog=lead
anguish	极大的痛苦	agony
analgesia	痛觉丧失	an=not, alg=pain
animadvert	非难	anim(=enmity)
animus	敌意，憎恨	anim(=enmity)
antic	古怪的	antique 古董
archer	弓箭手	arc=bow 弓
accolade	推崇，赞美	col(=coll=neck) 骑士称号授予典礼，接受拥抱
anesthetic	麻醉的，麻木的	esthet=aesthet=feeling
agnostic	不可知论的；不可知论者	gnos=gnot=know
adjudicate	充当裁判，判决	jud=judge
amnesia	健忘症	mne=memory
amnesty	大赦	mne=memory 没有记住
annihilate	消灭	nihil=nothing；nihilism 虚无主义
annul	宣告无效，取消	nul(=null)=none
acquit	宣告无罪，推卸义务和责任，还清债务	qui=res
acquisitive	渴望的，贪婪的	quisit=search,seek 精挑细选之意
abrade	擦伤，磨损	rad=ras=raz=scrape‘刮擦’
absolve	赦免，免除	solv=loosen, set free
aspersion	诽谤；洒水	spers=scatter
abstemious	有节制的，节俭的	stem 阻止，遏制；ab=away
abstention	节制，戒除，弃权	tent=hold；abs=away
acclimate	使适应	对气候（climate）的适应（acclimate）
ambush	埋伏，伏击	蹲在（am ）矮树丛（bush）中等人
adroit	灵巧的	机器人（android）很灵巧（adroit）
adjourn	推迟	原定日期（journ）增加（add）就是延迟、推迟之意
abnegate	否认，放弃	
abominate	痛恨，厌恶	
abortive	无结果的，无效的	
abound	大量存在，充满，富于	
abscond	潜逃，逃亡	
acarpous	不结果的	
accost	搭话	
accountability	有责任	
accrete	逐渐增长	
accrue	（利息等）增加，积累	
acedia	萎靡的样子，懒惰	
acuity	敏锐	
acumen	敏锐，精明	
addle	腐坏，混乱	
adduce	给予（理由），举出（例证）	
adventitious	偶热的	
advert	留意，提及	
agape	（嘴）大张的	
agreeable	愉悦的，欣然同意的	
ague	冷颤	
ail	生病	
aleatory	侥幸的，偶然的	
allay	减缓	
amass	积聚	
ambience	环境，气氛	
amity	友好关系	
anthem	圣歌	
aplomb	镇静	
apocryphal	虚假的	
apostate	叛徒	
apprentice	学徒	
apron	围裙	
aquiline	鹰的，似鹰的	
ardent	热心的，热烈的	
arraign	传讯，指责	
arrant	完全的，彻底的，极坏的	
arson	纵火罪	
asinine	笨拙的	
ballyhoo	大肆宣扬，喧闹	1880年一篇杂志文章描写一种鸟ballyhoo bird，称其四翅双头，可用一张嘴吹哨，同时用另张嘴唱歌
atone	赎罪，补偿	at one
atrocious	残暴的，凶恶的	atroc=cruel
backslide	死灰复燃，倒退	back + slide 开倒车
bamboozle	欺骗，隐瞒	bam 哄骗，欺骗
blanch	使变白，脸色苍白	blank
blear	模糊（的）	blur 模糊不清
bonhomie	好性情，和蔼	bon=good
bonny	健美的，漂亮的	bon=good
bondage	奴役，束缚	bond=serf 农奴
bracelet	手镯	brace 带子
befuddle	迷惑，醉酒昏迷	fuddle 迷糊，烂醉
bifurcate	二分分叉	furc=fork 分叉，bi=two
begrudge	吝啬；嫉妒	grudge 吝啬；妒忌，怨恨
beget	产生，引起	Like begets like. 有其父必有其子
blasphemy	亵渎（神明）	phem=phen=to show, visible
besmirch	诽谤	smirch 弄脏；污迹
besot	沉醉，糊涂	sot 醉鬼，嗜酒
attire	穿衣打扮，盛装	tire=rank, order 着装有序，使人整洁
atonal	（音乐）无调的	tune,tone
awry	扭曲的	wry
bazaar	集市	波斯语“东方国家的大集市”，新疆仍把集市叫做“巴扎”
barefaced	厚颜无耻的，公然的	赤裸裸地
augur	占卜，预兆	根据鸟的行为发现未来事物的预兆
badger	獾；迫使（某人吐露实话），诱使（某人暴露自己）	獾英勇侠义，骑士般地维护自己的洞穴，其头部白色，口鼻两侧有宽阔黑纹，就像徽章（badge）的标志，故此有名（badger）
berserk	狂怒的	狂野斗士（Berserker）穿着熊皮（ber）衬衫（serk）在战场上像动物一样口吐白沫口咬铁护甲，疯狂拼杀
browbeat	欺辱，吓唬	两条眉毛打架，也就是扬起眉毛吓唬人
august	威严的，使人敬畏的	罗马帝国第一位皇帝、凯撒侄孙Octavianus Gaesar的尊称：奥古斯都（Augustus）
azure	天蓝色（的）	希腊主神宙斯（Zeus），天堂的统治者，随行华盖的颜色为天蓝色（azure）
bale	大包，灾祸	音：包儿
backdrop	背景（幕布）	源于挂在舞台后面的彩色幕布
bowdlerize	删除，删改	源于删改萨翁作品的人Thomas Bowdler
assoil	赦免，释放，补偿	
assuage	缓和，减轻	
atheism	无神论	
aver	声明，断言，证实	
avow	承认，公开宣称	
badinage	打趣	
balderdash	胡言乱语，废话	
barrister	律师	
barter	物品交换，实物交易	
bawl	大声喊叫	
beacon	烽火，灯塔	
bearing	关系，意义，方位	
beatific	幸福的	
beckon	召唤，示意	
bedraggled	（头发、衣服等）弄湿的、凌乱的	
befoul	弄脏，诽谤	
behold	注视，看见	
beholden	欠人情	
behoove	理应，有必要	
belabor	喋喋不休；痛打，抨击	
bellow	咆哮	
berate	猛烈责骂	
betoken	预示，表示	
bicker	争吵，口角	
bide	等待，逗留	
bigot	偏执者	
bile	愤怒；胆汁	
bilk	躲债，骗取	
blandishment	奉承	
blare	高声发出	
blase	厌恶享乐的，玩厌倦了的	
blather	絮叨	
bleak	寒冷的，阴沉的	
blemish	损害，玷污，瑕疵	
bloated	肿胀的，傲慢的	
bob	轻拍	
bode	预示	
boggle	忧郁，退缩	
boo	发出嘘声	
boor	粗野之人，农民	
boreal	北方的，北风的	
bouffant	蓬松的，膨胀的	
bough	大树枝	
boulder	巨砾	
bouncing	活泼的，健康的	
bounteous	慷慨的，丰富的	
bovine	（似）牛的，迟钝的	
bracing	令人振奋的；支撑	
brackish	微咸的，难吃的	
brag	吹嘘	
braise	炖，蒸	
brat	孩子，顽童	
brattish	讨厌的，被宠坏的，无礼的	
bray	嘶叫，大声地发出声音	
brew	酿酒，沏茶，煮咖啡，酝酿，即将发生	
bridle	控制；马龙头	
bristling	竖立的	
brittle	易碎的，脆弱的	
bromide	庸俗的人，陈词滥调，镇静剂，安眠药	
bruit	散布（谣言）	
brusque	唐突的	
buck	反抗，抵制；雄鹿，雄兔，美元	
bucolic	乡村的，牧羊的	
buffet	连续打击	
buffoon	丑角，愚蠢的人	
cadence	抑扬顿挫，节奏，韵律	cad=fall
canvass	细查，讨论，拉选票	canvas 画布
catharsis	宣泄，净化	cathar=pure
caudal	尾部的	caud=tail
caustic	腐蚀性的，刻薄的；腐蚀剂	caust=caut=burn
cauterize	烧灼以消毒或止血	caut=caust=burn
cavalry	骑兵部队，装甲部队	caval=horse
celerity	迅速	celer=quick
cephalic	头的，头部的	cephal=head
cession	割让，转让	cess=go
cheeky	无礼的，厚颜无耻的	cheek 脸颊
cherubic	天使的，无邪的，可爱的	cherub小天使
ciliate	有纤毛的，有睫毛的	cili=eyelash 睫毛
clairvoyance	超人的洞察力	clair=clear
cleft	劈开的，裂缝	cleave的过去式；cut, then two sides left
clinch	钉牢，彻底解决	clench
coeval	同时代的	co=with,together；eva=age
cajole	哄骗	come to jail 哄骗小鸟入笼
centrifugal	离心的	fug=flee
bulge	凸起，膨胀	JB
colloquy	（非正式的）交谈，会谈	loqu=speak
centripetal	向心的	pet=seek
cello	大提琴	violin(小）、viola（中）
careworn	忧虑的，饱经忧患的	worn 经历多，或长期使用有磨损
coffer	保险柜	保险柜泡咖啡，饮用安全
burlesque	滑稽剧	不如乐死去
carouse	狂饮寻乐	动物庄园车子（car）狂舞（rouse）
comeuppance	应得的惩罚，因果报应	该发生的（come up）的躲也躲不掉
comestible	可吃的，食物	来桌上
checkered	多变的	棋盘格局多变
chisel	凿；凿子	切塞
catholic	普遍的，宽容的	天主教(Catholic）的教旨
careen	（船）倾斜，使倾斜	原用于表示汽车速度迅捷，导致忽然倾斜，后来借用表示轮船
cinder	余烬，煤渣	圆筒（cylinder）中盛满了煤渣（cinder）
clammy	湿冷的，发粘的	源于粘土(clay)，特征就是粘湿
clandestine	秘密的	宗派（clan）与命运（destine）均含“秘密”色彩
bullion	金条，银条	
bumble	说话含糊，拙劣地做	
bump	碰撞；碰撞声	
bumptious	傲慢的，自夸的	
bungle	拙劣地做	
buoy	支持，鼓励；浮标，救生圈	
burnish	擦亮	
burrow	挖掘，翻寻；地洞	
bustle	奔忙，忙乱；喧嚣	
butt	用头抵撞；粗大的一端，烟蒂	
buxom	体态丰满的	
cadet	军校生	
cadge	乞讨，占便宜	
callow	(鸟）未生羽毛的，（人）不成熟的	
calumniate	诽谤	
cameo	生动刻画，（演员）出演	
camouflage	掩饰，伪装	
canard	谣言，假新闻	
canary	金丝雀，女歌星	
canorous	音调优美的	
caper	雀跃，跳跃	
caress	抚摸	
carp	吹毛求疵；鲤鱼	
carrion	腐肉	
caucus	政党高级会议	
cavort	腾跃，欢跃	
cede	割让（领土），放弃	
cement	黏合，巩固；水泥，黏合剂	
chaff	谷壳；愚弄，戏弄，开玩笑	
char	烧焦，烧成炭	
charade	字谜游戏	
chaste	贞洁的，朴实的	
chasten	改正（坏习惯），磨练	
chic	漂亮的，时髦的	
chicanery	欺骗	
chimera	神话怪物，梦幻	
chipper	爽朗的，活泼的	
chirp	（鸟或虫）啾啾叫	
choleric	易怒的，暴躁的	
chuck	丢弃，解雇，辞职	
chuckle	咯咯地笑	
churl	粗鄙之人	
clasp	钩子，扣子	
cloy	（吃甜食）生腻，吃腻	
coagulate	使凝结	
coda	乐曲结尾	
coddle	溺爱，悉心照料	
collate	核对，对照	
colt	小雄马，新手	
coma	昏迷	
comely	美丽动人的	
confer	协商	conference
consul	领事	consult咨询领事
corporeal	肉体的，身体的，物质的	corp=corpor=body
countrified	乡村的，粗俗的	countri=country
cower	畏缩，蜷缩	cow母牛，威胁
coy	腼腆的	coy boy plays toys
crafty	狡诈的，灵巧的	craft 工艺，手艺
cranky	怪癖的，不稳定的	crank怪人
credence	信任	cred=believe, trust
credo	信条	cred=believe, trust
crepuscular	朦胧的，微亮的	crepuscle黄昏，黎明
crescendo	（音乐）渐强，高潮	cresc=grow, rise
crusade	为维护理想、原则做斗争	crus=cross十字军东征
culprit	罪犯	culp=fault
cutlery	餐具（刀叉匙等）	cut=刀
cyclone	气旋，飓风	cyc=cycle
cynosure	引人注意的对象，指引物；北极星	cyn=dog 狗尾巴，小熊星=北极星
dainty	娇美的，挑剔的；精美食品	dain=dign高贵
condign	罪有应得的，适宜的	dign=nobel
condole	哀悼，同情	dole音‘悼’
conducive	有益的	duc=duct=lead
confiscate	没收，充公	fisc=purse“钱包”，引申“国库”
covert	秘密的，隐蔽的	overt“公开的”
complaisant	顺从的，讨好的	plais=please
complicity	合谋，串通	plic=fold；com=with；共同策划
con	欺骗；反对论	pros and cons
compunction	懊悔	punct=prick
corrugate	起皱纹，起波纹	rug=wrinkle 皱纹
conscript	征兵	script=write 征兵报到登记
consecrate	奉献，使神圣	secr=sacr=holy
conspicuous	显著的，显而易见的	spic=look
coterminous	毗连的，交界的	termin=boundary,limit,end
contiguous	接壤的，接近的	tig=ting=tag=tact=touch
convene	集合，召集	ven=come
convulse	震撼	vuls=plunk,tear“收缩，撕开”
cozen	欺骗	编一打（dozen）谎话来欺骗；区分cozy 舒服的，安逸的
cupidity	贪婪	垂涎丘比特的法力
crackpot	怪人，疯子	见罐子（pot）就砸（crack）的家伙
deaden	减弱，缓和	将死之物，气息衰弱
conundrum	谜语，难题	蒙在鼓里
dank	阴湿的，透水的	人在河边（bank）走，怎能不湿鞋
curfew	宵禁	音：“可否”出行
daft	愚蠢的	音：呆
coup	妙计，成功之举	音：酷
congeal	凝结	
contumacious	违抗的，不服从的	
contumely	无礼，傲慢	
convalesce	康复，复原	
coronation	加冕礼	
coruscate	闪亮	
cosset	宠爱，溺爱	
covenant	书面保证；契约	
crab	螃蟹；抱怨；吹毛求疵	
crabbed	暴躁的	
cramp	箍紧；铁箍，夹子	
crass	愚钝的，粗糙的	
craven	懦弱的，畏缩的	
creep	匍匐前进，悄悄移动	
crib	剽窃	
crimp	使起皱，使（头发）卷曲，抵制，约束	
croak	蛙鸣；抱怨	
croon	低吟，低唱	
crouch	蹲伏，弯腰	
crumb	糕饼屑，面包屑；少许	
crumble	弄碎，崩溃	
cub	幼兽	
cuddle	拥抱	
cull	精选；挑除的东西	
cumber	拖累，妨碍	
curdle	凝结，变稠	
dabble	涉足，浅尝	
dally	闲荡，嬉戏	
dapper	整洁漂亮的，敏捷的	
daub	涂抹，乱画	
dawddle	闲逛，虚度光阴	
daze	迷乱，恍惚，眩晕	
demagogue	蛊惑民心的政客	agog=lead；dem=people；发动人民起来造反
debonair	美丽的，温雅的	bon=good；debo=戴安娜 + 赫本
disburse	支付，支出	burs=pouch, purse 口袋，钱袋，钱包；从钱包里往外掏
decoy	诱骗	coy腼腆的
dillydally	磨蹭，浪费时间	dally闲耍
deface	损坏	de+face
dejected	沮丧的，灰心的	de=down；ject=cast,throw
delirium	精神错乱	delir 说胡话，发狂
dentures	假牙	dent=teeth
despotic	专横的	despot 暴君
dictum	格言，声明	dict=say,declare
distrait	分心的	distracted
dither	慌张，犹豫	don't dither, just try，底瑟
disenchant	使不抱幻想，空洞的	enchant入迷，陶醉
defraud	欺骗	fraud欺骗
defuse	拆除引信，出去危险	fuse引信
delinquent	玩忽职守的	linqu=linger 闲逛
delusion	欺骗，幻想	lus=lud=play
deluxe	豪华的，华丽的	luxurious
dismantle	拆除	mantle 覆盖，斗篷
demarcate	划分，划界	marc=mark
demented	疯狂的	ment=mental
demoralize	士气低落	morale 士气，道德；moral 道德(的)
demote	降级，降职	mot=move
denude	脱去	nude=naked
denunciate	公开指责、抨击	nunci=nounce=speak
diaphanous	（布）精细的，半透明的	phan=show；dia=apart, through
disposed	愿意，倾向于	pos=posit=put
depose	免职，宣誓作证	pos=posit=put 放倒
depredation	掠夺，破坏	pred=prey 掠夺，捕食；predator 捕食者
deracinate	根除，灭绝	raci=race
disruptive	制造混乱的	rupt=break
dissemble	假装，掩饰	semblance外表，伪装
desiccate	完全干涸，脱水	sicc=dry
dissimulate	隐藏，掩饰	simulate模拟，假装
desist	停止，中止	sist=stand
desolate	荒凉的，被遗弃的	sol=lone
dissolute	放荡的，无节制的	solut=solv=loosen,set free
despise	鄙视	spis=spic=look
despoil	夺取，抢夺	spoil“宠坏，抢夺”
destitute	缺乏的，贫困的	stitut=statut=set up, place
dissuade	劝阻，阻止	suad=urge
desuetude	废止，不用	sue=suit
detergent	清洁剂	terg=wipe
detraction	诽谤，贬低	tract=draw,pull
diatribe	抨击	tri=trit=rud摩擦
dimple	酒窝，笑靥	地母婆
dire	可怕的	地热管道破裂
debunk	揭露真相，暴露	号外号外，重磅（bunk）新闻
debrief	盘问，听取报告	简报
dispatch	派遣，迅速处理；迅速	时间碎片（patch）管理好，并发效率高
dishevel	使（头发）蓬乱	铁铲（shovel）理发蓬乱不堪
dismay	沮丧，气馁	未得到上帝的祝愿（may）
delectation	享受，愉快	源于delight
desideratum	必需品	源于desire
discretionary	自由决定的	自由市场经济
debris	碎片，废墟	
decant	轻轻倒出	
declaim	高谈阔论	
defile	玷污；峡谷，狭路	
deflect	偏离，转向	
defray	支付，支出	
delicate	娇弱的，精致的	
den	兽穴，窝	
detonate	引爆	
dicker	小生意；还价	
dingy	肮脏的，昏暗的	
dint	击出凹槽	
disaffect	使不满，使疏远	
disavow	否认，抵赖	
disclaim	放弃权利，拒绝承认	
discombobulated	扰乱的，打乱的	
disfigure	损毁外形，使变丑	
disfranchise	剥夺权利（公民权）	
disguise	假扮，掩饰	
dispense	分配，分发	
disport	玩耍	
disproof	反证，反驳	
dreary	沉闷的，乏味的	A dream has never been dreary.
embroil	使混乱，使卷入纠纷	broil争吵
epidermis	表皮	derm=skin
duress	胁迫	doing under pressure
doleful	悲伤的	dole音‘悼’
draggy	拖拉的，极为讨厌的	drag拖拉
dulcet	美妙的，悦耳的	dulc=sweat
duplicitous	两面派的，奸诈的	dup=dub=doubtful
elliptical	椭圆的，晦涩的，省略的	ellipse（椭圆）+ellipsis（省略号）
empower	授权，准许	em+power
emote	激动而表达感情	emotion
engulf	吞噬	en(in) + gulf
endue	赋予，授予	endue=endow=provide
environ	包围，围绕	environ-ment周围环境
epilogue	收场白，尾声	epi=upon；logue=say
eugenic	优生（学）的	eu=well,good；gen=beget,generate
eulogy	颂词，颂文	eu=well,good；log=logy=thought,word,speach
effeminate	缺乏勇气的，柔弱的	femin=femine 女性
enfetter	上脚镣，束缚	fetter脚镣，源于feet
ensue	追求；接着发生	follow, persue
effulgent	灿烂的，光泽的	fulg=shine
etch	蚀刻，铭记	itch“痒”
elocution	演说术	locut=loqu=speak
emaciate	使瘦弱	maci=lean
emissary	密使，特使	miss-misson
enunciate	发音，（清楚地）表达	nunci=announce
dyspeptic	消化不良的，不高兴的	pept=peps=digest, eupeptic消化良好的，peptic易于消化的
empyreal	苍天的	pyr(o)=fire，旧时以为天由火与光构成，火实为星光
enshrine	奉为神圣，珍藏	shrine圣地
ensnare	诱入圈套、陷阱、罗网	snare陷阱，罗网
espionage	间谍活动	spi=spy
espy	突然看到，望见	spy“窥探”
divagate	离题，漂泊	vag=wander
evict	（依法）驱逐	vict=conquer
envisage	正视，想象	vis=see
elixir	万能药，长生不老药	阿拉伯买药人喊“阿里可舍”：这个药好啊！
doff	脱掉（外衣，帽子等）	大伏酷热，解衣纳凉
dock	剪短，扣除（薪水，津贴等）；码头	倒扣，到客
earthshaking	极其重大的或重要的	地动山摇的大事件
dodge	闪开，躲避	躲之
droll	古怪的，搞笑的	二人转满地打滚（roll）学驴叫
entrust	委托，托付	给予信任（trust）的行为
entreat	恳求	棺材铺老板找到教父，恳求（entreat）其摆平（treat）女儿之事
dowdy	不整洁的，衣着过时的	老叫花子倒地不起，浑身脏臭
entourage	随从，环境	旅行（tour）之路环境多变，应当带个随从
drawl	慢吞吞地说（方式）	每句话都拉长了说，慢声慢语，急煞人也
errand	差事，差使	跑（ran）来跑（ran）去，各种会议，各种出差
emasculate	使柔弱，阉割；柔弱的	切掉雄性（mascul）特征
engross	全神贯注于	全部（gross）精力（energy）集中
dote	溺爱，昏聩	人老多疑（doubt），对孩子则逗他（do-ta）宠他
embolden	鼓励	使大胆（bold)
enjoin	命令，吩咐	使加入即命令
ersatz	代用的，假的	使用假的（error）满足（sate）需要
drip	使滴下；水滴	水滴滴答（drop）
edgy	急躁的，易怒的，锋利的	贪官经由刀尖（edge）下逼的拱门，急躁愠怒无可奈何
ebullience	（感情等）奔放，兴高采烈，沸腾	西班牙斗牛（bull）豪情奔放，气氛热烈
encomiast	赞美者	喜剧演员（comedian）过来助兴
dour	严厉的，阴沉的，倔强的	心中有气面色阴沉，却还坚持隐忍（endure）
ecumenical	世界范围的，普遍的	一口闷的饮酒风气并非中国独有，风靡全球
ejaculate	突然说出或叫出，射出	一下子出来了
eerie	可怕的，怪异的	咦（e-e)，日(ri）！
drub	重击，打败	音：“抓脖”痛击，片甲不留
elegy	哀歌，挽歌	音：哀乐季
douse	浸入水中，熄灭	音：都湿
drawn	憔悴的	音：内心焦灼，形容枯槁
emolument	报酬，薪水	音：一摸六百万（million），哦又发工资咯
emerald	翠绿色的；翡翠	音：一抹绿的
ennui	倦怠，无聊	源于annoy
drench	使湿透	源于drink，衣服（dress）喝水（drink）
droop	低垂，萎靡	源于drop
draconian	严厉的，严峻的	源于雅典政治家Draco制定严刑峻法。音：暴龙dragon
drivel	胡说；糊涂话	远途开车（drive）说话解闷
drool	流口水，胡说	中风者不仅语浊，还口水横流
divine	神圣的，非凡的；推测，预言；神学家	
earthy	粗俗的，土气的	
easel	黑板架，画架	
ecstasy	狂喜，入迷	
eidetic	（印象）异常清晰的，极为逼真的	
emanate	散出，发出，发源	
enchant	使陶醉，施魔法于	
enormity	巨大的；暴行	
enrapture	使狂喜，使高兴	
ensconce	安置，安坐	
ensign	舰旗	
epideictic	夸耀的	
epigram	讽刺短诗，警句	
epithet	绰号，称号	
equable	稳定的，不变的，温和的	
equine	马的，似马的	
expropriate	充公，没收	appropriate 拨款，盗用
excoriate	剥皮，严厉批评	cori=skin，一次批斗扒层皮
excruciate	施酷刑，折磨	cruci=crude “残忍的”
exculpate	开脱，申请、证明无罪	culp=fault
excursive	离题的	curs=run，满嘴跑火车，谈着谈着就脱轨了
expulsion	驱逐，逐出	expel
fatidic	预言的	f=ph，pro-phetic
famish	使饥饿	famine
fancied	空想的，虚构的	fancy “想象的事物”
febrile	发烧的，热病的	febr=hot，febrifuge退热药，二月（Feb）份农历新年刚过，各种发热疾病
feisty	活跃的，易怒的	felic=happy,merry
felicitate	祝贺，庆祝	felic=happy,merry
filial	子女的	filial peity子女孝顺
finable	应罚款的	fine “罚款”
fissile	易分裂的	fission “分裂，裂变”，音：飞丝
fitful	间歇的，不规则的	fit （熟词生意：间歇发病的）
fluvial	河流的，生长在河中的	fluv=flu=flow
flux	不断的变动，变迁，动荡不安	flux=fluv=flu=flow
folksy	亲切的，友好的	folks
fondle	抚弄，抚摸	fond “喜爱的”
foppish	纨绔子弟的，浮华的，俗丽的	fop “纨绔子弟”
fracture	骨折，折断，裂口	fract=break
fraternal	兄弟的，兄弟般的	frater=brother
exhume	掘出，发掘	hum=ground，从地下出来
flighty	轻浮的，反复无常的	light 轻
fluke	侥幸，意想不到的事	luck 幸运
expatriate	驱逐，流放，移居国外	patr=father
explicable	可解释的	plic=fold；ex=out；把折叠隐藏的事物打开，使人释然
expound	解释，阐述	pound ≈ pose
expurgate	删除，删节	purge 净化，清除
extirpation	消灭，根除	stirp “种，根” exterminate
forswear	誓绝，发誓放弃	swear
extemporize	即兴演说	tempor临时的，没有准备
extenuate	掩饰，减轻	tenu=thin，大事化小小事化了
extradite	引渡	tradi=trade，换出（ex）
extrude	挤出，推出，逐出	trud=thrust 挤出
exigent	迫切的，紧急的	urgent
flutter	拍翅	utter 发声，发射，流通；小鸟振翅飞翔（fly）
execrate	憎恶，咒骂	xecr=sacr=sacred，背弃神明为邪恶可憎之人
exude	渗出，慢慢流出	xude为sweat的变体
exult	欢腾，喜悦	xult=sult=jump, leap
flit	掠过，迅速飞过	飞过头顶
felon	重罪犯	飞轮猛击致死行为
fiat	法令，政令	菲亚特汽车
expostulate	抗议，告诫	告示（post）参与者，游行活动遵守事项
flagellate	鞭打，鞭笞	挥舞旗子（flag）抽打(late）形如鞭笞
extort	勒索，敲诈	拷打（torture）勒索其钱财
filibuster	妨碍议事，阻挠议案通过（人或行动）	美国议员连续阅读与提案无关萨翁作品，目的就是阻挠议案通过
expatiate	详述	耐心（patient）地说
flak	高射炮，抨击	旗子一挥，万炮齐鸣
expunge	删除	肉中刺（punge）绝对要除掉
fealty	效忠，忠诚	音：倍儿铁
faze	打扰，扰乱	音：烦死
finagle	盗取，骗取	音：非拿够
fatuity	愚蠢	音：肥头猪
foyer	门厅，休息室	音：佛谒
exiguous	太少的，不足的	源于exigent， 紧急物品量都比较少
flaccid	松弛的	源于flabby
exceptionable	引人反感的，可反对的，可抗议的	
exceptional	特别（好）的，例外的，异常的	
excrete	排泄，分泌	
expiate	补偿，赎罪	
factitious	人为的，不真实的	
fathom	彻底了解，弄清真相；英寻（水深单位）	
feint	佯攻，伪装	
felicitous	（说话等）适当的，得体的	
feline	猫的，猫科的	
feral	凶猛的，野性的	
filth	污物，猥亵的行为	
flair	天赋，天资	
flatulent	肠胃气胀的，空虚的，浮夸的	
flay	剥皮，抢夺，掠夺，严厉指责	
fleece	生羊皮，羊毛	
flimflam	欺骗，胡言乱语	
flinch	畏缩，退缩	
flossy	华丽的，时髦的，柔软的	
foist	偷偷插入，（以欺骗的方式）强加	
foment	煽动	
footle	说胡话，做傻事，浪费时间	
foray	突袭，劫掠	
forbidding	令人生畏的，险恶的，反感的	
foreclose	排除，取消赎回权	
forensic	公开辩论的，争论的	
forgo	放弃，抛弃	
forward	过激的，鲁莽的	
fragrant	芳香的	
frenzy	狂乱，暂时性疯狂	
friable	脆的，易碎的	
gargantuan	巨大的，庞大的	《巨人传》的巨人Gargantua
fructify	使结果实，使成功	fruit
fruition	实现，完成	fruit
furor	喧闹，轰动，盛怒	fury 狂怒
gaiety	欢乐，快活	gai=gay 快乐的
garner	谷仓，积蓄；储存，贮藏	garn=furnish “装饰，供应”
garnish	装饰	garn=furnish “装饰，供应”
garrulity	唠叨，饶舌	garr=chatter 絮絮叨叨
gaseous	气体的，气态的	gas-related
genesis	创始，起源	Genesis表“创世纪”
genteel	有教养的，彬彬有礼的	gentle
gerontocracy	老人统治的政府	geront=old man；cracy=crat=government,rule,authority
gestate	怀孕，孕育	gest=bear=carry
gimmick	噱头	gimm=gymn=naked 使用裸体女郎引人注目
gobble	贪婪地吃，狼吞虎咽	gob 大块，大量
gracile	细弱的，纤细优美的	graceful
granule	小粒，微粒	gran=grain 颗粒， grand=huge
grasping	贪心的，贪婪的	grasp 抓取
gratuity	赏钱，小费	grat=thank 表示感激的费用
grotesque	（外形或方式）怪诞的，（艺术等）风格怪异的	grotto（岩洞） + picturesque（图画的）
groove	沟、槽、辙；（刻出的）字沟，习惯	grove 树丛
grouch	牢骚，不满，好抱怨的人	grudge, grumble
gruesome	令人毛骨悚然的，阴森的	grueling 折磨的；痛打，惩罚
guffaw	哄笑	guff “胡言乱语”
gustation	品尝，味觉	gust=taste
harry	掠夺，袭扰，折磨	harass
hallucination	幻觉	luc=bright,light，illusion
gutter	水槽，街沟	utter 发声，发射，流通；流水通过水槽流出去
greenhorn	初学者，容易受骗的人	初出茅庐的人，青涩（green）单纯
halcyon	平静的，愉快的，繁荣的	传说神翠鸟（halcyon）可平息风浪
gambol	雀跃，嬉戏	赌博（gamble）赢钱后欢呼雀跃
gulch	峡谷	海洋深沟为海湾（gulf），陆地深沟成峡谷（gulch）
hanker	渴望，追求	旱渴（春苗久旱逢甘雨）
harrow	耙；耙地，使痛苦	箭头（arrow）射入
frowzy	不整洁的，污秽的	看到它就皱眉头（frown）
gauche	笨拙的，不会社交的	罗马“左”，迷信说法为“不吉”（wrong），笨拙的；“dexter”“右”则是“吉祥”（right），灵活的
grill	烤，拷问	炮烙之刑将人绑至通红的铜柱上烤烧并严加拷问
gingerly	谨慎的（地）	切生姜（ginger）时小心姜汁溅入眼中；红头发的人被人戏称是姜丝
full-blown	成熟的，盛开的，全面的，完善的	全面开花
hangdog	忧愁的，低贱的	无主之贱狗，或忧愁于饥渴咬人的疯狗会被吊死
gander	雄鹅，笨蛋，傻瓜；闲逛	性别（gender）都区分不了的家伙
gangling	瘦长而难看的	音：杠铃 像杠铃那般细长而难看的
goldbrick	逃避责任，偷懒	源于美国西部淘金热，打造金块时弄虚作假
glib	圆滑的，能言善辩的	在图书馆（library）读书多，懂得也多
gape	裂开，目瞪口呆地看	嘴巴洞开（gap），十分吃惊
frolic	嬉戏，雀跃	
frothy	气泡的，空洞的	
frumpy	邋遢的，老实的，过时的	
full-bodied	魁梧的，浓烈的，重要的	
fulminate	猛烈抨击，严厉谴责	
fumble	搜索，笨拙地搜寻，弄乱，搞糟	
fume	发怒，愤怒，冒烟	
funk	怯懦，恐惧；懦夫	
funky	有霉臭味的，有恶臭的	
furbish	磨光，刷新	
gab	饶舌，爱说话，空谈，瞎扯，闲逛，游荡	
gaff	大鱼钩，鱼叉	
gaffle	失礼，失态	
gangway	（上下船的）跳板，样板，舷梯	
gargoyle	（雕刻成兽状的）滴水嘴，面貌丑陋的人	
gaunt	憔悴的，瘦削的	
gavel	（法官所用的）木槌	
gawky	迟钝的，笨拙的	
gild	镀金	
gist	要点	
gleam	微光，闪光	
glean	拾（落穗），收集（材料等）	
glee	欢喜，高兴	
glimmer	发微光；摇曳的微光	
glow	发光，发热，（脸）发红，兴高采烈	
glower	怒目而视	
glowing	热情赞扬的	
gnaw	啃，咬；腐蚀，侵蚀	
goad	赶牛棒；刺激，激励	
goggle	护目镜；睁大眼睛看	
goof	犯错误，闲逛	
gourmand	嗜食者	
gourmet	美食家	
gravel	碎石，砂砾	
gripe	抱怨，恼怒，激恼	
grisly	恐怖的，可怕的	
grit	沙粒，决心，勇气；下定决心	
grove	小树林，树丛	
grovel	摇尾乞怜，奴颜婢膝	
gruff	粗鲁的，板着脸孔的，（声音）粗哑的	
grump	发脾气，生气	
gumption	进取心，魅力	
guttle	狼吞虎咽	
guzzle	大吃大喝，大量消耗	
gyrate	旋转的；旋转，回旋	
haggard	憔悴的，瘦削的	
harangue	长篇攻击演说	
harbinger	先驱，预兆	
harp	竖琴；弹竖琴，喋喋不休地说或写	
harpsichord	键琴	
inanimate	无生命的	anim=breath, life, spirit
imbibe	喝，吸入	bib=drink
incarcerate	关进监狱，监禁	carcer=prison
incur	招致	cause
incertitude	不确定的，无把握，怀疑	certi(=certain)
incinerate	焚化，焚毁	ciner=ash
incite	激发，刺激	cit=call,start；excite 兴奋，激发，增加能量
incriminate	连累，牵连	crimin=crime “罪行，控诉”
incubation	孵卵期，潜伏期	cub=lie down
incubus	梦靥，沉重的负担	cub=lie down；鬼压身
inculcate	敦敦教诲，反复灌输	culc(=cult)=till 耕种，培养
inculpate	控告，归咎于	culp=blame, fault
indelible	擦拭不掉的，不可磨灭的	delete
indemnify	赔偿，偿付	demn=harm
induct	使就职，使入伍	duct=lead
ineluctable	不能逃避的	elude 躲避，逃避
ineffable	不可言喻的，难以表达的	fable 寓言
impinge	侵犯，撞击	fringe
hauteur	傲慢	haut(=high)
hearken	倾听	hear-ken “视野范围，见地”
hector	欺凌，威吓	hecatomb 百牲祭，大屠杀
hedge	树篱，保护手段；障碍	hedge fund 对冲基金
herbivorous	食草的	herb=grass, vor=swallow
hortative	劝告的，激励的	hort=garden
horticulture	园艺学	hort=garden
howler	嚎叫的人或动物，滑稽可笑的错误	howl 嚎叫
hubris	傲慢，目中无人	hub 中心，ris(=rise），惟我独尊的态度
hurtle	呼啸而过，快速通过，猛掷	hurl=fling 投掷
idolatrize	奉为偶像，盲目崇拜	idol=image
idolize	奉为偶像，崇拜，仰慕	idol=image
illuminati	先知	lumin=light
illustrious	显著的，显赫的	luster 光泽，光彩
immolate	牺牲，祭祀	molar 磨牙，磨，原指用磨碎的小麦食物作为祭祀用品
immure	监禁	mur = wall
impale	刺入，刺穿	Neo的头部刺入管子，浑身颤抖脸色发白
impeach	指摘，弹劾	peach 告密，揭发
impend	威胁，即将发生	pend=hang
impenitent	不知悔悟的	penitent 忏悔的；惩罚（penalty）后有所醒悟
implicate	牵连，暗示	plic = fold；im=in；裹挟进去
implode	内爆，剧减	plod = big noise
implore	哀求，恳求	plor=cry, weep
importune	强求，胡搅蛮缠	port = carry
imprecation	诅咒	precat(=pray） 未虔诚祈祷，遭受上帝诅咒
inappreciable	微不足道的	preci=value
impregnable	固若金汤的，无法攻破的	preg(=prehend）=grasp
impuissance	无力，虚弱	puissance 力量，权利
heartrending	令人心碎的	rend 分裂，撕碎；heartrending = heartbreaking
inch	慢慢前进、移动	冰冻三尺非一日之寒
imbecile	低能者，弱智者，愚蠢的人	不够数
headlong	轻率的（地），迅猛的（地）	长驱直入落入敌方埋伏，全军覆没
hew	砍伐，遵守	伐木时遵守统一喊号嘿哟嘿哟
huffy	愤怒的，恼怒的	愤怒的小鸟在胡飞（hu-fei）乱撞
hoe	锄头	镐
hoist	提起，升起；起重机	工人吼一声，起重机将石板吊起
hobble	蹒跚，跛行	哈尔的移动城堡
hunker	蹲下，顽固地坚持	憨祸都比较固执
hue	色彩，色泽，信仰	绘
hoodoo	厄运，招来不幸的人	祸都；voodoo 巫术
homage	效忠，敬意	精忠报国
highbrow	自以为文化修养高的人	眉毛高挑自以为是
hone	磨刀石；磨刀	磨刀霍霍（ho-ho）向牛羊
heave	用力举	盘古双手擎天（heaven）
hearsay	谣传，道听途说	听（hear）说（say）谁谁怎么了
immemorial	太古的，极其古老的	无法（im）记得（memory）的前生记忆
inchoate	刚开始的，未充分发展的，不成熟的	燕麦（oat）才长一寸（inch）长
inebriate	灌醉；酒鬼，酒徒	一挨杯就狂饮
hoary	（头发）灰白的，古老的	音：毫瑞（毫毛 + 瑞雪 = 白发苍老）
hoarse	嘶哑的，粗哑的	音：嚎嘶
heady	任性的，鲁莽的	音：黑的司机随意要价，态度蛮横
heresy	异端邪说	音：邪说（say）
imbroglio	纠纷，纠葛	与embroil同源， broil 争吵
hoax	欺骗；骗局，恶作剧	源于魔术咒语hocus-pocus；coax 哄骗
hermetic	密封的，神秘的，深奥的	源于希腊发明之神Hermes
husband	节省，节约	丈夫（husband）省钱（husband），妻子花钱
hash	杂乱，混乱	
hasten	加速，加快，促进	
hazy	朦胧的，不清楚的	
heckle	诘问，责问	
hectic	兴奋的，繁忙的，忙乱的	
hidebound	思想偏狭且顽固的	
hie	疾走，快速	
hike	抬高，提高；徒步旅行	
homely	朴素的，不漂亮的	
hoop	（桶的）箍，铁环	
humor	纵容，迁就	
hurdle	克服（障碍等）；跨栏，障碍	
hush	肃静，安静；使安静下来	
hymn	赞美诗	
hype	夸大的广告宣传	
ilk	类型，种类	
immanent	内在的，固有的，普遍存在的	
impasse	僵局，死路	
impel	推进，驱使	
inclement	严酷的，严厉的	
invoice	发票，发货清单；开发票	en+voy 船运，原指船运货物的价格清单
jaunty	轻松活泼的	enjoy
infature	使迷惑，使糊涂	fatu=foolish,useless
inflame	激起，加剧，变红，发炎	flame 火焰，光辉，激情；fame 名誉，名望
infract	违反，违犯	fract=break；infringe
jug	用陶罐等炖，关押	gail，音：加盖（炖）
jabber	快而含糊地说	gibber 叽里呱啦地说
ingress	进入	gress=walk,step, go
infernal	地狱的，可恶的	inferior 次级的，低级的；地下阎罗，凶神恶煞
instate	任命	install
ire	愤怒；激怒	irate
interject	插入，插话	ject=cast,throw
jettison	（船等）向外抛弃货物；抛弃的货物	jet 喷气式飞机 动画：喷气式喷出来的是行李
jocund	快乐的，高兴的	joc=joke
jaunt	短途旅游（行）	journary 长途旅行
jovial	愉快的	jovi(=joy)
juxtapose	并列，并置	juxta=beside, near；pos=posit=put
kudos	名誉，名声	kudo=glory
labile	易变化的，不稳定的	lab-il(l=e) 病毒变异，很不稳定
interlace	编织，交错	lace 线
lacerate	撕裂，深深伤害	lacer=tear
lachrymose	爱哭的，引入落泪的	lachrym(=lacrim)=tear,cry
lactic	乳汁的	lact=milk
interlard	使混杂，混入	lard 猪油，夹杂，润色
lank	细长的，长，直且柔软	long
interloper	闯入者	lope 大步慢跑
interlude	间歇	lud=lus=play
lackluster	无光泽的，呆滞的	luster 光泽
intermission	暂停，间歇	miss=mit=send
intermittent	断断续续的，间歇的	mit=miss=send
inoculate	注射预防针	ocul=eye
interpose	置于中间，使介入	pos=posit=put
jaudice	偏见	prejudice，judic=judge
insurrection	造反，叛乱	rect=stright 起来不愿做奴隶的人们
inscribe	（在某物上）写，题写	scrib=script=write
insignia	徽章	sign=signal
insouciance	莫不关心的，漫不经心的	souci=soul 没有灵魂的
intersperse	散布，点缀	spers=scatter
intestate	未留遗嘱的	test=witness
intoxicate	使沉醉，使欣喜若狂，使喝醉	tox=poison，酒多伤身
inundate	淹没，泛滥，压倒	und=wave
invective	谩骂，痛骂	vect=carry
inveigle	诱骗，诱使	veig(=vein) 面纱，用面纱蒙上眼
inveterate	根深蒂固的	veter = old
invidious	招致仇恨、嫉妒、反感	vid=vis=see
lampoon	讽刺文章；讽刺	方舟子挑灯（lamp）写文章讽刺学术不端之人
inroad	袭击，（以牺牲他人为代价取得的）进展	拦路抢劫，环球旅行
inkling	略知，模糊概念；暗示	墨迹性格测试，通过对墨迹的模糊看法，判断其性格
infantry	步兵	人类战争发展的婴儿期(infant)使用人海战术，主要军种即步兵
jar	震动，冲突，抵触，震惊，发出刺耳声；光口坛子	坛子里潘多拉怪兽横冲直撞
insuperable	难以克服的	无法超越（super）的障碍
jumpy	紧张不安的，心惊肉跳的	心跳（jump）就罢了，眼皮也跟着跳（jump)
lair	窝，巢穴，躲藏处	燕子掺入毛发（hair）做窝（lair）
lambaste	痛打，痛骂	野兽（beast）对羊羔（lamb）各种虐
irk	使苦恼，使厌烦	音：饿渴
jeer	嘲笑	音：讥尔
jejune	空洞的，不成熟的	音：佶屈聱牙
jounce	颠簸地移动	音：桨死，不灵活
jerk	猛拉	音：劫客，飞车贼抢包
knack	特殊能力，窍门	音：可拿（出手），knock 敲
languid	没精打采的，倦怠的	音：懒鬼的
knead	揉成，捏制	音：捏的
josh	（无恶意地）戏弄，戏耍	音：瞧戏
jamb	门窗侧柱	注册的人拥挤不堪（jam），很多人脸都贴到了门框上
innuendo	含沙射影，暗讽	
inspissate	使浓缩	
inter	埋葬	
interstice	裂缝，空隙	
inveigh	痛骂，猛烈抨击	
jab	猛刺	
jagged	锯齿状的，参差不齐的	
jamboree	喧闹的集会	
jape	开玩笑，戏弄	
jarring	声音刺耳的	
jibe	符合，一致	
jockey	骑师；谋取	
jolt	颠簸；震动，摇晃	
jostle	推挤，挤开通道	
jot	草草记下，摘要记录	
kipper	腌制，熏制	
lowbred	粗野的，粗俗的	bred(=breed）
latch	门闩；闩牢	catch
lore	知识，全部传说	folklore 民间传说
lesion	损伤，伤口	give him a lesson，对他而言就是伤口或损伤
laxative	（药）通便的；泻药	lax
leach	过滤	leak
lithe	柔软的，易弯曲的，自然优雅的	leather 柔软，同lissome
lethargy	昏睡，呆滞，懒散	leth=oblivion 遗忘
liberality	慷慨，心胸开阔	liberal 自由的，开放的
licentious	放荡的，纵欲的	lic=allure 吸引
liken	比作	like 像
liquefy	（使）液化，（使）溶解	liq=flow
liquidate	清算，清偿	liqui(=liquity）使用流动资产偿还到期债务（date）
locus	地点，所在地	loc=place
locution	语言风格，惯用语	locut=speak
luster	使有光泽、光彩，增光，放光；光泽，光彩	luc=lust=light, shine
lurch	突然倾斜，蹒跚而行	lunch吃喝多了既如此
lustrous	有光泽的	lust=luc=light, shine
lusty	充满活力的，精力充沛的	lust=luc=light, shine
macerate	浸软，使消瘦	macer=lean；音：梅酥软的
magniloquent	夸张的	magn=great, large；loqu=speak
majestic	雄伟的，庄严的	maj=greater
malaise	不适，不舒服	mal=bad,wretched；aise(=ease）
malediction	诅咒	mal=bad,wretched；dict=say,speak,proclaim
malefactor	罪犯，作恶者	mal=bad,wretched；fact=do,make；benefactor 善人
malfeasance	不法行为，渎职	mal=bad,wretched；feas(=fic)=fact=do,make
maleficent	有害的，作恶的，犯罪的	mal=bad,wretched；fic=fact=do,make
marvel	感到惊异；奇迹	marvellous
mash	捣成糊状	m-ash（灰） 弄成灰
masquerade	伪装；化装舞会	masque=mask 区分：清真寺 mosque
matte	无光泽的	mat（垫子，粗糙的，无光泽）
mattress	床垫	mat（垫子，粗糙的，无光泽）
matriculate	录取	matr=mater=mother 使之成为母校；matrix 矩阵，母体
medicate	用药治疗的，加药于	medicine
mellifluous	（音乐等）柔美流畅的	mell=honey，flu=flow
lopsided	倾向一方的，不平衡的	sid=sed=sit
lust	强烈的欲望	wonderlust 旅行癖
meddle	干涉，干预	裁判站在中间（middle）拉来双方调和
largess	赠送，赏赐，捐款	大方
lucre	（贬义）钱，利益	见钱（lucre）眼放光（luc）发热（re）
ligneous	木质的，木头的	可点燃的（ign），可照明的（light)
lissome	柔软的	可以弯成S形，柔韧度好
lathe	车床；车床加工	拉车->车床
lout	笨蛋	邋恶\ la-wu-teng （方言）
lymphatic	无力的，豪华的，迟缓的，淋巴的	淋巴（lymph）
marshal	整理，安排，排列	马歇尔元帅规划队列方阵与进军计划
lucewarm	微湿的，不冷不热的	平衡的（luck） + warm
limn	描写，描画	石灰（lime）画线（line），由简入繁
lunatic	疯子；笨的	西方旧时认为，精神病与月（luna）盈亏有关联
liaison	密切的联系，暧昧的关系	音：li + ai + son 类似文爱马
lug	拖，拉	音：拉个
lunge	冲，扑	音：狼狗 看到食物，挣着链子往前扑
loiter	闲逛，游荡，虚度光阴，消磨时间	音：老头，遛鸟打弯儿，喝茶听曲儿
libel	（文字）诽谤，中伤	音：离败 离间败坏
levee	堤岸，防洪堤	音：篱圩 篱笆圩子防洪堵水
leer	斜视，送秋波	音：立眼儿
leeward	顺风的	音：利 方向
lurk	潜伏，埋伏	音：猎客 在等猎物的靠近
lucubrate	刻苦攻读，埋头苦干，专心著作	音：撸裤背（单词）；挑灯（luc）夜战
lope	轻快的脚步，大步跑	音：路坡，下坡时步子大，速度快
luscious	美味的，肉感的	音：螺蛳清蒸
maraud	抢劫，掠夺	音：马虏的 马是虏获的
manure	施肥；粪肥	音：马尿 做肥料
madrigal	抒情短诗，合唱曲	音：马嘴歌 一首短诗改编的合唱曲
marrow	精髓，精华	音：脉络，人之脉络精致，造物主之精华
maunder	胡扯，游荡	音：盲的（盲目的）
limbo	不稳定的状态，中间状态	原指“地狱边境”
magenta	粉红色的；紫红色	源于意大利城市Magenta
lap	舔食	嘴唇 lip
lard	猪油；使丰富，使充满	
lark	玩笑，嬉戏	
lassitude	疲倦无力，没精打采	
lavender	薰衣草；淡紫色的	
lease	出租；租约，租期	
leery	谨防的，怀疑的	
levelheaded	头脑冷静的，清醒的	
limnetic	淡水的，湖泊的	
limp	跛行；软弱的，无力的	
lionize	崇拜，看中	
list	倾斜	
loaf	一条（面包）；虚度光阴	
long-winded	冗长的	
lumber	跌跌撞撞地走，笨拙地走，杂木，木材	
lump	块，肿块；形成块状	
mangle	毁坏，毁损	
marsupial	有袋动物（的）	
martyr	烈士，殉道者	
mast	船桅，桅杆	
masticate	咀嚼，磨成浆	
maul	打伤，伤害	
mawkish	自作多情的，过度伤感的，无味的，作呕的	
meander	蜿蜒而流，漫步	
measly	患麻疹的，少得可怜的，微不足道的	
meek	温顺的，顺从的	
obloquy	辱骂，斥责	loqu=speak；ob=against
mushy	糊状的，感伤的，多情的	mash 捣成糊状，思绪纷繁，为情所困
mendacious	不真实的，虚假的，习惯性说谎的	mend=free from fault
mendacity	不诚实	mend=free from fault
mendicant	行乞的；乞丐	mendic=beg
mince	切碎；装腔作势地小步走	min=less, small
minuet	小步舞	min=less, small
minutia	细枝末节，琐事	min=less, small
minnow	鲤科，小鱼	min=less, small；今日（now）小鲤鱼，明日跳龙门
mirage	海市蜃楼，幻象	mir=wonder, amazement；miracle
mirth	欢乐，欢笑	mir=wonder, amazment；音：没事 自然轻松愉快
missive	信函，（尤其）公函	miss=sent
modish	时髦的	model 时尚
modicum	少量	moderate
molest	骚扰，困扰	mol=grind ‘磨’
mollycoddle	过分爱惜，娇惯；娇生惯养之人	moll（软的），coddle（纵容）
moody	喜怒无常的，抑郁的	mood 情绪
mumble	咕哝，含糊不清地说	murmur
mutineer	反叛者，背叛者	mut=change
nasal	鼻子的，有鼻音的	nas=nose
natal	出生的，诞生时的	nat=nasc=born
nausea	作呕，恶心，晕船	naus(=nav)=ship 晕船就会恶心
nautical	船员的，船舶的，航海的	naut=ship
nugatory	无价值的，琐碎的	negative
niggling	琐碎的，吹毛求疵的	niggle 拘泥于小节，niggard 小气鬼
nostrum	家传秘方的，江湖药，万灵丹，秒策	nost=home
obnoxious	令人不愉快的，可憎的	nox=harmful
numinous	超自然的，精神上的	numen 守护神，天才
numismatist	钱币学家或收藏家	numismat=coin
misperceive	误解	perceive 感觉和认知
obsess	迷住，困扰，烦扰	sess=sed=sid=sit
mutter	咕哝，嘀咕	utter 发声，发射，流通；发出模糊的声音；murmur
muster	召集，聚集	大师（master）总是有很多人跟随，具有号召力
nefarious	极恶毒的，邪恶的	非（ne）法（fa）
misgiving	疑虑	感恩节（thanksgiving）感谢土著，仍然心存疑虑（misgiving）
nethermost	最底的，最下面的	荷兰（Netherland）是“低地”的意思，也称“低地国家”
mettle	勇气，斗志	金属（mental）般的硬度：勇敢、坚强
oasis	绿洲	困在沙漠，用植物拼成SOS符号
mores	习俗，惯例	礼多人不怪，多多（more + s）益善
miscreant	恶棍，歹徒；邪恶的，异端的	李靖咒骂道，怎么生出（mis-created）这么个孽障
muzzy	头脑糊涂的	麻醉时头脑不清
mope	抑郁的，闷闷不乐；情绪低落	猫扑上发帖的很多都是愤青
mistral	寒冷且干燥的寒风	密斯托拉风（吹响法国南部）
milk	榨取	奶牛们无法容忍人类的压榨，起来闹革命，战争经费来源就是牛奶
muniments	契约	钱（money）买来的契约
namby-pamby	乏味的，懦弱的；懦弱的人	诗人Ambrose Philips被人攻击，称其作品Namby-Pamby
narcissism	自恋，自爱	希腊神话美少年纳西塞斯，恋上水中自己的倒影，憔悴而死化作水仙花
noose	绳圈，套索	妖怪松开（loose）一条绳子，直扑向悟空，捆锁住了他
moldy	发霉的	音：长“毛的”
muffle	消音，裹住	音：麻缚
munch	用力咀嚼，出声咀嚼	音：忙吃
muggy	（天气）闷热而潮湿的	音：闷极
mien	风采，态度	音：迷人 的风采和态度
morsel	（食物）一小口，一小块	音：馍丝儿
moribund	即将结束的，垂死的	音：末日旁的
nadir	最低点	音：拿底儿
nag	不断叨扰，指责，抱怨	音：那个那个，这个这个
nimble	敏捷的，灵活的	音：泥巴儿，雨天玩泥巴的小儿，很敏捷灵活
menthol	薄荷醇	源于mint，男人（men）馊了（thol），拿块薄荷除臭
mesmerism	催眠术，催眠引导法	源于催眠术的创始人Mesmer
nemesis	报应	源于希腊复仇女神Nemesis
muse	沉思，冥想	源于希腊缪斯女神，音：默思
mete	给予，分配；边界	
miff	小争吵	
minutes	会议记录	
moat	壕沟，护城河	
monsoon	季风	
mote	尘埃，微尘	
muck	施肥，捣乱；堆肥，粪肥	
mull	思考，思索；混乱	
multifarious	各式各样的	
nettle	烦扰，激怒；荨麻	
nifty	极好的，极妙的	
occlude	使闭塞	clud=close,shut
percolate	过滤出，渗透	col=strain 排水
peremptory	不容反抗的，专横的	empt=take,procedure；per=thoroughly；empt=empty 伴君如伴虎，依他为中心周围空白一片，随人不得随意近前
perforate	打洞	for=born,drill；per=thoroughly 打穿
pellucid	清晰的，清澈的	luc=bright,light
ocular	眼睛的，视觉的	ocul=eye
odoriferous	有气味的	odor 气味
offbeat	不规则的，不平常的	off（偏离）+ beat（节奏，跳动）
ointment	油膏，软膏	oint(=oil)
oleaginous	油腻的，圆滑的，满口恭维的	ole=oil
olfactory	嗅觉的	ol源于odor，fact=do,make
opine	想，以为	opinion
oratory	演讲术	or=mouth；orate 演讲
ordain	任命（神职），颁布命令	order
ordinance	法令，条例	ordin=order
ornery	顽固的，爱争吵的	orn=decorate 装饰，为装修相互争吵，彼此不相让
osseous	骨的，多骨的	oss=bone
outlandish	古怪的	out-land 地面土地上的家伙，行为古怪
otiose	不必要的，多余的	out-toss 扔出的都是多余的
pang	一阵剧痛	pain
pallid	苍白的额，没血色的	pall=be pale
pall	令人发腻，失去吸引力	pall=be pale；音：怕咯，受不了了
palliate	减轻（痛苦），掩饰（罪行）	palli=cloak 斗篷，掩护，遮掩
palpitate	（心脏）急速跳动	palp=feel
parity	同等，相等	par 票面价值，同等水平
parturition	生产，分娩	par=bring forth
parley	和谈，会谈	parl=speak
pastoral	田园生活的，宁静的	pastor 牧人，牧师
peachy	极好的，漂亮的	peach 桃子，桃色，美人儿，极好的事物
pedestal	（柱石或雕像的）基座	ped=foot，建筑的脚
peep	瞥见，偷看；初现	peek
peery	窥视的，好奇的，怀疑的	peer
pell-mell	混乱地	pell=push,drive；mell(=meddle） 混乱的
penance	自我惩罚	pen=punish
pendent	吊着的，悬挂的	pend=hang
perambulate	巡视，漫步	per=thoroughly,aumbul=walk
periphrastic	迂回的，冗赘的	peri=around, phras(=phrase） 说过绕来绕去不知所云
parlous	靠不住的，危险的	perious，音：怕了死
perishing	严寒的	perish 毁灭，死亡，腐烂，凋谢；北极严寒之地，漫长的冬季即死亡之季
pauper	贫民	poor；音：破袍
pare	削，修剪，缩减	prune, repair
orotund	（声音）洪亮的，夸张的	rotund （人）圆胖的，（声音）洪亮的
obstreperous	吵闹的，难管束的	streper=noise
obverse	正面的	vers=turn，反面（ob）翻转（verse）过来就是正面（obverse）
peckish	饿的，急躁的	鹌鹑啄起（peck）笼子来，跳着叫着，显然是饿急了
palaver	空谈，奉承	苍白（pal=pale）的断言（aver）
omelet	煎蛋卷	蛋（o）我（me）吃（let）一个
palatial	宫殿般的，宏伟的	宫殿（palace）
overbearing	专横的，独断的	过分（over），无法忍受（bear）
overweening	自负的，过于自信的	过分（over）相信（ween）自己
pan	严厉批评	灰太狼家的平底锅
pastiche	混合拼凑的作品	剪贴（paste）拼接的东西
obtuse	愚笨的，迟钝的	没有（obt）用（use）的大笨蛋
other-directed	受人支配的	其他人（other）支配的（directed）
overhaul	彻底检查	全部（over）拉出来（haul）看看
panorama	概观，全景	全景（pan=all）+ 照相机（camera）
pawn	典当，抵押；被利用的小人物（工具、马前卒）	所有权（own≈awn）易主
pane	窗格玻璃	天津瓷房子用盘子（pan）拼窗
peculate	挪用（公款）	投机交易（speculate）缺钱用，无奈压上本钱（$=s）
occult	秘密的，不公开的	邪教（cult）是不敢公开的
oven	烤箱，烤炉，灶	音：爱闻 烤出来的东西很香
perch	（鸟等）栖息	音：泊栖
ogle	送秋波；媚眼	音：噢，girl
ode	长诗，颂歌	音：讴（歌）
parry	挡开，避开	音：趴里边 躲子弹
parch	烘烤，烤焦	音：啪唧，水滴到炭火、木材上的声音
pagan	没有宗教信仰的人，异教徒	音：爬竿 骑墙头的人，并没有明确的信仰，两边都认为是异教徒
penury	贫穷，吝啬	音：贫农女
pelt	扔；毛皮	音：网络用语“拍他”寓意攻击，批判
osmosis	渗透，潜移默化	音：我哧摩丝 润湿渗透，保护发型，已经潜移默化
ooze	慢慢地流，渗出，逐渐消失	音：污渍 墙壁上雨天浸入雨水，晴天慢慢消失
peddle	兜售	音：有人“拍兜”喊叫，售卖衣物
offish	冷淡的	鱼（fish）跳走（off）了，池塘就冷清（offish）了
pastry	糕点，点心	源于paste 面糊、粘贴
pandemonium	喧嚣，大混乱	源于弥尔顿失乐园中的地狱之都；pan=all，demon 魔鬼，全部是魔鬼
overreach	做事过头	
overriding	最主要的，悠闲的	
palette	调色的，颜料配置	
pamper	纵容，过分关怀	
pander	怂恿，迎合（不良欲望）	
passe	已过盛年的，过时的	
pavid	害怕的，胆小的	
peak	憔悴，消瘦	
pecan	山核桃	
proceeds	收入，实收款项；继续前行	ced=ceed=cess=go
precept	箴言，格言，规则	cept=hold,take
precocious	早熟的	coc=cook,ripen；早（pre） + 熟（coc）
procrastinate	耽搁，拖延	cras=tomorrow
predilection	偏爱，嗜好	dile=esteem,love
profane	亵渎，玷污	fane=temple 神庙
prefigure	预示，预想	fig=fict=form,shape
perjure	做伪证，发假誓	jur=swear,law
pertinacious	固执的，坚决的	per + tenacious
pester	纠缠，烦扰	pest 害虫， 黑压压袭来
pettish	易怒的，闹情绪的	pet 宠物，宠坏的孩子，不悦，生气；很容易闹情绪
petty	琐碎的，次要的，小气的	pet 宠物，宠坏的孩子，不悦，生气；任何小事都能找茬
petrify	（使）石化，（使）吓呆	petr=rock
philately	集邮	phil=love
phoney	假的，欺骗的	phony；音：糊弄你
picayunish	微不足道的，不值钱的	picuni=money
piscatorial	捕鱼的，渔业的	pisc=fish
piteous	可怜的	pity
pittance	微薄的薪俸，少量的收入	pity 少得可怜
placard	招贴，布告；张贴布告	place + card
plaudit	喝彩，赞扬	plaud
plebeian	贫民的，平庸的，粗俗的；贫民	pleb=people
plenary	全体出席的；完全的，绝对的，无限的	plen=full
plenitude	完全，大量	plen=full
plentitude	充分	plen=full
pleonastic	冗言的	pleon(=plen=full)；true fact与free gift都属于冗言
ploy	花招，策略	ploy ≈ play
plummet	垂直或突然落下	plummet 原意为“测深锤”
pluralist	兼任多个宗教职位者；兼职者	plur=plus=more
plush	豪华的	plus=more
podium	讲坛，（乐队）指挥台	pod=ped=foot 脚踩着的地方
polemic	争论，论战	polem=war；存在问题（problem），就会彼此争论（polemic），彼此论战（polemic）
polymath	博学者	poly=many；多学多艺
ponderable	可估量的	ponder=weight
preponderant	占有优势的	ponder=weight
postiche	伪造的，假的；伪造品，假发	post=afer,behind；che(=cheat)
potentate	统治者，君主	potent=powerful
potentiate	加强，强化	potent=powerful
prate	瞎扯，唠叨	prattle 闲聊
preamble	前言，序言，先兆	pre + amble（漫步）
prehensile	能抓住东西的，缠绕的	prehens=grasp
presumption	假定，自大	presume 假设，假定，冒昧
privation	匮乏，贫困	priv=seprate
presage	预感，预示	sage 智者，智慧
prescience	预知，先知	sci=know
persnickety	势利的，爱挑剔的	snick（=snob)
presupposition	预想，臆测	supposition 假定，推测
pretension	要求，主张，自负，做作	tens=stretch,strain
prevaricate	闪烁其词，搪塞	vari(=vary）
pervious	可渗透的，可通过的	vio(=via)=way
prevision	预知，先见	vis=see
peruse	细读，精读	彻底（per=thoroughly）使用（use），完全消化
piebald	花斑的，黑白两色的	花马
plangent	轰鸣的，凄凉的	拉丁文：plangere “拍打胸脯以示哀痛”
plod	沉重地走，辛勤工作；艰难行进	埋头拉犁（plough）的人
pound	猛击，连续撞击，（心脏）狂跳，怦怦地跳	拟声词
pied	杂色的	派（pie）中放入各种颜色的配料（青菜，火腿，奶油）
prance	昂首阔步走	普鲁士（Prus）军队昂首挺进法国（France）
preposterous	荒谬的	前（pre）因后（post）果完全颠倒
potpourri	混杂物，杂烩	往锅里（pot）倒（pour）各种食材
posit	断定，认为	衍：postulate
preen	（鸟用嘴）整理羽毛，（人）打扮修饰	音：脯翎
pestle	杵，碾槌	音：拍死头
pontifical	教皇的，自负的，武断的	音：胖体肥口 主教、教皇（pontiff）
pilfer	偷窃	音：痞儿
pillage	抢劫，掠夺	音：痞儿
poohed	疲倦的	音：坡害的 骑自行上一条坡度近60度，长度约100公里，爬上去不得累死
persiflage	挖苦，嘲弄	音：婆师傅 星星物语“我是师傅，不是婆师傅”
perk	恢复，振作，打扮，竖起	音：破壳 新生事物打破沉寂，一派欣欣向荣之势
premiere	（电影、戏剧等）首次公演或公映；突出的，杰出的	源于：premier 首要的，最早的
platonic	理论的，精神上的，纯友谊的	源于柏拉图（Plato）
procrustean	强求一致的	源于希腊神话巨人Procrusters，抓到人后将体长者截去下肢，体短者拉长使其与床齐长
pharisaic	伪善的，伪装虔诚的	源于犹太教法利赛(Pharisee），只是形式上遵守教义
prank	恶作剧，玩笑	曾有人调侃说谷歌用page-rank给网页排名就是一个笑话（prank），事实证明他错了
perverse	刚愎自用的，固执的	总是（per=thoroughly）与人对着（vers=turn）干
pervert	使堕落，滥用，歪曲	总是（per=thoroughly）与人对着（vert=turn）干
potboiler	粗制滥造的文艺作品	作品档次太低，躲不过在锅（pot）底下烧掉的命运：作品支配拿来烧火用
piddle	鬼混，浪费	
piddling	琐碎的，微不足道的	
piecemeal	一件一件的，零碎的	
pinch	捏，掐，少量	
piquant	辛辣的，开胃的，刺激的	
pique	(自尊心受伤而导致的）不悦，愤怒；激怒	
piroutte	脚尖着地的旋转	
pith	精髓，要点	
plait	发辫；编成辫	
plank	厚木板，要点；铺板	
pleat	（衣服上的）褶	
pledge	发誓；誓言，保证	
plunder	抢劫，掠夺	
poach	偷猎，窃取	
pod	豆荚，剥掉（豆荚）	
poncho	斗篷，雨披	
pother	喧扰，骚动；烦恼	
pouch	使成袋状，装入袋中；小袋	
prepossessing	给人好感的	
ramble	漫步	amble 漫步，缓行
rapprochement	友好关系；恢复邦交	approach
rebarbative	令人讨厌的，冒犯人的	barbarian 野蛮人
recess	壁龛，休假	cess=go
recline	斜倚，躺卧	clin=lean
refract	折射	fract=break 杯子里的筷子，像折断了一样
refulgent	辉煌的，灿烂的	fulg=shine
refurbish	刷新，擦亮	furbish 擦亮，磨光
progenitor	祖先	gen=bear,beget,race,kind
progeny	后代，子孙	gen=bear,beget,race,kind
prognosis	（对病情的）预判，预测	gnos=gnot=know
regurgitate	涌回，流回，反胃，反刍	gurgite(=engulf 狼吞虎咽）
relapse	旧病复发，再度恶化	laps=slide,slip
remand	遣回，召回	mand=order,commit 命令回来
promissory	允诺的，约定的	miss=sent；promise
rapport	融洽，和谐	port=carry
protagonist	倡导者，拥护者	prot=first，agon=struggle
proverbially	人尽皆知的	proverb 谚语 自然人尽皆知
prowess	勇敢，非凡的才能	prow=prou=proud
puerile	幼稚的，孩子气的	puer=child,boy
puffery	极力称赞的，夸大广告，吹捧	puff 噗噗地吃气，吹捧
pulchritude	美丽，标致	pulchr=beautiful
propulsion	推进力	puls=drive,push
punctilious	谨小慎微的	punct=prick，用针挑刺时一定小心
purvey	（大量）供给	pur(=pro) + vey(=vide) = provide
purge	洗涤，清洗	purg=cleanse(=pure)
purgatory	炼狱	purg=cleanse(=pure) 涤罪之所
pusillanimous	胆小的	pusill=weak，anim=breath,life,spirit
putative	公认的，推定的	put=reckon
putrefy	使腐烂	putr=rotten
quotidian	每日的，平凡的	quoti(=every) + di(=day)
rakish	潇洒的，放荡的	rake 浪子，流氓
rampage	乱冲乱跑；狂暴行为	ramp（斜坡，狂跳乱撞)
rant	大声责骂，咆哮	rant and rave 大声叫嚷
rapacious	掠夺的，贪婪的	rap=snatch 捕，夺
rapt	入迷的，全神贯注的	rap=snatch 捕，夺；夺去所有精神，全身心投入
rapids	激流	rapid 迅速的
rasp	发出刺耳的声音，锉，刮削	ras=rad=raz=scrapt 刮，擦
ratiocinate	推理，推论	rat=calculate
ration	定量配给；配给	rat=calculate
ravel	使纠缠，纠结，拆开，拆散	rav=rapt=rap=snatch 捕，夺
ravening	狼吞虎咽的，贪婪的	rav=rapt=rap=snatch 捕，夺
ravish	使着迷，强夺	rav=rapt=rap=snatch 捕，夺
rebuff	断然拒绝的	re（=back) + buff(=puff 吹，捧）
recant	撤回（声明），放弃（信仰）	re（=back) + cant(=sing）
redemptive	赎回的，救赎的，挽回的	redeem
recusant	拒不服从者	refuse
reminisce	追忆，回想	reminiscence
remission	宽恕，豁免	remit
prorogue	休会，延期	rog=ask
rambunctious	骚乱的，喧闹的	rumple(皱，乱） + robustious（强壮的，粗野的，猛烈的）
protuberance	突起，隆起	tuber (马铃薯等的)块茎，球根
provenance	出处，起源	ven=come
recollection	记忆力，往事，回忆	回想（recollect）过去
purse	缩拢，皱起（嘴唇，眉毛）；钱包	撅起的嘴唇颇似缩拢起来的钱袋口
pullet	小母鸡	里约上帝之城，躲避子弹（bullet）的小母鸡
quell	制止，镇压	平息（quiet）吵闹、抗议
rack	使痛苦不堪，使备受折磨	田径运动（race）我最吃不消，痛苦啊
refectory	（学院等的）餐厅，食堂	为恢复体力（refresh）所去的地方
rattle	使发出咯咯声，使慌乱	响尾蛇（rattlesnake）
rankle	怨恨，激怒；红肿，发炎	像蛇（snake）咬出来的伤口
puny	弱小的，孱弱的	小矮马（pony）看起来弱不禁风
quail	畏缩，发抖，恐惧	也指鹌鹑，生性胆小
redress	矫正，修正	衣服（dress）的法语动词为（arrange）
quaff	痛饮，畅饮	音：“夸父”追日，渴极痛饮
purloin	偷窃	音：pull-all-in 从别人家拉东西
quibble	遁词	音：回避，磕巴
quandary	困惑，进退两难，窘境	音：渴望得力 人在困境渴望得到别人的帮助
rabid	患狂犬病的，疯狂的，狂暴的	音：拉毙掉 疯犬肆虐，拉来毙掉最省力
pundit	权威人士，专家	源于 pandit 学者，专家
reconnoiter	侦查，勘察	源于法语，to recognize
protean	变化多端的，多变的	源于希腊神话中变化不定的海神Proteus
prolix	嗦的，冗长的	
promenade	散步，开车兜风	
prong	刺，贯穿；叉子，尖齿，齿状物	
prop	支撑物，支柱；支持	
providential	幸运的，适时的	
puissant	强大的，有权利的	
pullulate	繁殖，充满；发芽	
pulp	果肉，纸浆	
pulpit	（教堂的）讲道坛	
pushy	有进取心的，爱出风头的，固执己见的	
quirk	奇事，怪癖	
quondam	原来的，以前的	
raff	大量，许多	
ransom	赎回；赎身，赎金	
ready	敏捷的，迅速的	
recherche	精心挑选的，异国风味的	
recumbent	斜靠的，休息的	
redolent	芬芳的，芳香的	
redoubtable	令人敬畏的，可怕的	
reek	发臭味，冒烟	
reel	卷轴，旋转；卷到轴上	
rejoin	回答，答辩	
relic	遗物，遗迹，遗风	
remit	免除，宽恕，汇款	mit=send
remittance	汇款	mit=send
remonstrate	抗议	monstr=show
renunciate	放弃	nunci=announce
repent	懊悔，后悔	pen=punish 惩罚以后开始后悔
repine	不满，抱怨	pine 憔悴
repose	休息，安眠	pos=posit=put
repulsion	厌恶，反感，排斥力	puls=drive,push
scrape	刮擦，擦掉	rap=rad=ras=raz=scrape‘刮擦’
ruddy	（脸色）红润的，红的	red
reprieve	缓期执行，暂缓解救；缓刑，暂缓	repr-ieve
reprobate	非难，斥责	repr-obate
reproof	责备，斥责	repr-oof
rife	流行的，普遍的	rite 惯例，礼仪
rumple	弄皱，弄乱	rump=rupt=break
rumpus	喧闹，骚乱	rump=rupt=break
rupture	破裂，断裂	rupt=break
sacrilege	亵渎，冒犯神灵	sacr=holy,lege=to gether 偷圣物的人
salve	减轻，缓和；药膏	salv=save
sangfroid	沉着，冷静	sang(=sanguin=blood) + froid(=frozen) = 冷血的
sartorial	裁缝的，缝制的	sartor 裁缝（谑）
scribble	乱写，乱涂	scrib=script=write
scripture	经文，盛典	script=scrib=write
scrutable	可以了解的，可解读的	scrut=search
scintillate	光芒闪耀，（言谈举止中）焕发才智	sintill=spark
retort	反驳	tort=twist
retrench	节省，紧缩开支	trench=cut
scutter	疾行，急跑	utter 发声，发射，流通；健步如飞，如发射导弹
revulsion	厌恶，憎恶，剧变	vuls=pull
ribald	下流的，粗俗的	白天（ri）光（bald）着身子
rent	裂缝，分歧	出租屋出现裂缝，租客与房东发生分歧
rollicking	欢乐的，喧闹的	滚石（roll-stone)舔着青草，快速滚动
renege	食言，违约	回过头（re)就否认（neg)
scabrous	粗糙的	结疤的（scab)能不粗糙
ruckus	喧闹，骚动	酒吧里舞者经常遇到“拉裤子”的咸猪手
rout	溃败	军队腐败（rot），怎么可能不败
saunter	闲逛，漫步	看（s=see)姑姑（aunt）去
rudder	船舵；领导者	路德（马丁）黑人民权领袖
rove	流浪，漂泊	美国NASA发射的漫步者号（rover）卫星
renal	肾脏的，肾的	能够再生的内脏器官：割肾买苹果
scuff	脚擦着地走	拟声词
scrawl	潦草地写，涂乱	蛇（snake）爬（crawl）过去的字体，弯弯扭扭，鬼画符啊
ruse	骗术，计策	送玫瑰（rose)是捕获女生芳心的一种常用（use）计策（ruse）
scud	疾行，飞奔	兔、鹿等短尾（scut）动物，跑起来都很快
rustle	发出沙沙声	响尾蛇（rattle-snake ）出动
seafaring	航海的，跟海洋相关的	行至海洋（sea)深处的（far)，seafarer（水手，船员）
scorch	烧焦，烤焦	音：烧烤气 烧烤冒气，煳啦
scoff	嘲笑，狼吞虎咽；嘲笑，笑柄	音：屎壳夫 嘲笑之意，调侃其贪食
scruffy	肮脏的，不洁的	音：屎壳郎粪 屎壳郎就够脏的啦，更别提它的便便咯
scotch	镇压，扑灭	英格兰大军压境，镇压苏格兰（Scotland）独立兵团
scurry	疾行，急跑	源于hurry-scurry 慌乱；curr=run 嗖(s)地一声跑了
satiny	光滑的，柔软的	源于satin（绸缎），“泉州”名称由阿拉伯传入法国到英国
scurvy	卑鄙的，下流的	源于scurf 头皮屑；curv=bent 爱好 骚(s)
scrumptious	可口的，美味的	源于sumptuous 奢侈的，豪华的 房屋 - 饮食
rend	撕碎，分裂，抢夺	
render	表演，翻译	
repartee	机敏的应答	
repercussion	反响，反应，影响，回声	
requite	报答，报复	
resourceful	机智的	
retch	作呕，恶心	
retouch	修描（照片），润色	
rhubarb	（植物）大黄，热烈的讨论，激烈的争论	
rig	（用不正当手段）操纵，垄断	
rile	惹恼，激怒	
rind	（瓜、果等的）外皮	
rinse	冲洗掉，漂净	
ripple	使泛起涟漪；波痕，涟漪	
ritzy	高雅的，势利的	
rive	撕开，开裂	
riveting	非常精彩的，引人入胜的	
roe	鱼卵	
rote	死记硬背	
roundabout	绕道的，迂回的	
ruffle	弄皱，激怒；褶皱	
rumble	发出低沉的隆隆声	
runic	古北欧文字的，神秘的	
sag	松弛，下垂	
sash	肩带，腰带	
saucy	粗鲁的，俏皮的，漂亮的	
scads	许多，巨额	
scald	烫伤，烫洗	
scamp	草率地做；流氓，顽皮的家伙	
scowl	怒容；生气地皱眉，怒视	
scraggly	凹凸不平的，散乱的	
scrimp	节省，精打细算	
shamble	蹒跚而行，踉跄而行	amble 缓行，漫步
slur	连音符，含糊发音，忽略	blur 模糊不清
snare	圈套，陷阱	ensnare
smudge	污迹，污点；弄脏	mud
sequestrate	扣押，没收；使隐退	se=apart, quest=seek,search
senile	衰老的	sen=old man，如senior
sentient	有感觉能力的，意思到的	senti=feel
sentiment	多愁善感，思想感情	senti=feel
sentinel	哨兵，岗哨	senti=feel
sequacious	盲从的	sequ=follow
seraphic	如天使般的，美丽的	seraph 守卫上帝宝座的六翼天使
serenade	夜曲	Serena 塞丽娜，爱情小夜曲；seren 平静的；siren 汽笛、警报、妖妇
serpentine	像蛇般弯曲的，蜿蜒的	serp=crawl,creep；serpent 大毒蛇
shattered	破碎的	shatter 粉碎，破碎
simper	假笑，傻笑	simp 笨蛋
smirk	假笑，傻笑	simper
slick	熟练的，圆滑的，光滑的	slide
slippage	滑动，下降	slip
slot	狭槽	slot machine 投币机（自动售货、游戏等）
slug	猛击，拳击	slug it out 一绝雌雄
smattering	略知，少数	small + matter
solitude	孤独	sol=alone,only
somatic	肉体的，躯体的	soma=body
somnolent	想睡的，催眠的	somn=sleep
sophism	诡辩，诡辩法（术）	soph=wise
sorcery	巫术，魔术	sorcercer 男巫师，魔术师
spindly	细长的，纤弱的	spindle 纺锤，锭子
sliver	薄长条；裂成细片	split
slump	大幅下降，暴跌	房价、股市大跳水（jump）；slum 贫民窟
slake	消除，满足	放松弛（slack）即可消除(slake）疲劳，使你得到满足（slake）
seamy	丑恶的，污秽的	缝合（seam）时若针脚大，不仅难看还易藏污纳垢
sententious	说教的，简要的	灌一段一段（sentence)的心灵鸡汤，无非就是说教罢了
sleight	巧妙手法，诡计，灵巧	狡猾（sly） + 八面玲珑（eight）=灵巧，诡计
sermon	布道，说教，训诫	萨满教；布道(sermon）时常要说阿门（say-amen）
sift	筛选，过滤	筛子（sieve）过滤（filter）
skullduggery	欺骗，使诈	水晶头骨（skull）的挖掘（dug-dig）存在各种骗局
shipshape	整洁干净的，井然有序的	像舰船一样整齐排列（arranged as a ship should be）
shilly-shally	犹豫不决，虚度时光	一遍遍地问：shall I
sere	干枯的，枯萎的	音：色热 感觉颜色发热
serried	密集的	音：筛粒的， 像筛子上颗粒那般地密
slobber	口水；流口水，情不自禁地说	音：湿了脖 口水流得都打湿了脖子
slit	撕裂；裂缝	音：撕裂，slice
slattern	不整洁的；邋遢的女人	音：死邋碜
slouch	没精打采的样子	音：似老去
sheaf	一捆，一束	音：媳妇 抱一捧花去接机
shear	剪（羊毛），剪发	音：洗耳 剪发后一道必备程序，之后再挖耳朵
sheen	光辉，光泽	音：喜人
shudder	战栗，发抖	音：吓的 看杰克逊的chill吓的
shabby	破旧的，卑鄙的	音：亵逼（方言）
shoddy	劣质的，假冒的	音：锈的 买把刮胡刀（shaver），发现竟然锈的
skirmish	小规模战斗，小冲突	印度与巴基斯坦为克什米尔（Kashmir）发生冲突
sear	烧焦	源于sere(干枯的)
simile	明喻	源于similar，使用不相似的事物作比即明喻（simile）
seep	(液体等）渗漏	
self-assertion	自作主张	
sever	断绝，分离	
shirk	逃避，回避	
shove	推挤，猛推	
shrewd	机灵的，精明的	
shriek	尖叫	
sibyl	女预言家，女先知	
simmer	炖，慢煮；将沸腾/发作的状态	
simonize	打蜡，擦亮	
singe	（轻微地）烧焦，烤焦	
skit	幽默讽刺短剧	
skittish	轻浮的，活泼的	
slant	倾斜；斜面，观点	
slay	杀戮，杀死	
slew	使旋转；大量	
slink	溜走，潜逃	
slog	猛击，苦干	
sloppy	邋遢的，粗心的	
slosh	溅，泼；泥泞	
slue	使旋转	
slumber	睡眠，安睡；催眠	
slurp	出声地吃货喝；啜食（声）	
sly	狡猾的，狡诈的	
smarmy	虚情假意的	
smear	弄脏，玷污；污迹，污点	
smirch	弄脏；污点	
smite	重击，猛打	
smut	污迹，黑穗病；弄脏	
snappish	脾气暴躁的	
snappy	生机勃勃的，漂亮的，时髦的	
snarl	纠缠，混乱；咆哮，怒骂（声）	
snatch	强夺，攫取	
sneer	嘲笑，鄙视	
snicker	窃笑，暗笑	
snide	挖苦的，讽刺的	
snip	剪断；剪，碎片	
snipe	狙击	
snitch	告密，偷	
snooze	打盹儿，打瞌睡	
snuggle	紧靠，依偎	
soak	浸泡，渗透	
sock	重击，痛打	
sodden	浸透了的	
soggy	湿透的	
soil	弄脏	
sparring	拳击，争斗	
spasmodic	痉挛的，间歇性的	
spat	口角，小争论	
spate	许多，大量；（水流）暴涨，发洪水	
spatter	洒，溅	
speck	斑点；少量	
spell	一段时间	
spew	呕吐，大量喷出	
spiel	滔滔不绝地讲话	
spite	怨恨，恶意	
splashy	容易溅开的，炫耀显眼的	
spleen	怒气	
stoke	添加燃料	1900挥舞铁铲（shovel）给锅炉（stove）加燃料（stoke）
subcelestial	世俗的，尘世的	celestial 天上的
stonewall	拖延议事，设置障碍	filibuster
superimpose	重叠，叠加	impose 强加
subjugate	征服，镇压	jug=yoke 轭，束缚
suborn	收买，唆使，贿赂	orn=embellish 装饰 私底下（sub）打点一二
supplicate	恳求，祈求	plic=fold；sup=below； 腰弯（fold）下（sup），向对方请求
subpoena	传票（律），传讯	poena(=penalty） 可能遭受刑罚的传讯（subpoena）
subreption	隐瞒真相，歪曲事实	rept=crawl,creep
supererogatory	职责以外的，多余的	rog=ask
spoilsport	败兴的人	spoil“破坏，宠坏，抢夺”
spoliate	抢劫，掠夺	spoil“破坏，宠坏，抢夺”
sport	炫耀，卖弄	sport a beard 故意蓄着个大胡子
spurt	(液体等的）喷出，迸发	spout，squirt
sprint	短距离全速赛跑	spring up 速动
squalor	肮脏，污秽	squal=dirty, filthy
statute	法规，法令	statut=stitut=set up, place
staid	稳重的，沉着的	stay的过去式
sticky	湿热的，闷热的；粘的	stick 棍棒，粘贴
stickler	坚持己见的人，困难的问题	stickle 坚持己见
stitch	一针，针脚；缝合	sting
stench	臭气，恶臭	stint
stouthearted	刚毅的，大胆的	stout（勇敢的，坚决的，肥胖的） + heart = 胆儿肥
straiten	使为难，使变窄	strait 海峡，彼此相隔遥远的陆地经过板块漂流，彼此相接，航路已经很难通过
stranded	搁浅的，处于困境的	strand 绳，线，搁浅，陷入困境
strangulation	扼杀，勒死	strangle 扼杀
substratum	基础，地基	stratum 层，社会阶层
stricture	严厉谴责的	strict 严格的
striate	加条纹	strip
sublimate	升华，净化	sublime 崇高的，庄严的；升华
subterfuge	诡计，托辞	subter=under, fug=flee
subsume	包含，包括	sum=take
surfeit	饮食过量，过度	sur=over, feit=do,make
swagger	大摇大摆地走	swag 摇晃
stutter	口吃，结巴	utter 发声，发射，流通；发音磕磕盼盼
swerve	突然改变方向	veer
straggle	迷路，落伍，蔓延	爱丽丝发现环境很陌生（strange)，看来是迷路咯
stuffy	通风不好的，闷热的	东西（stuff）塞满(stuff）通风就差，闷热（stuffy）自不待说
square	一致，符合，结清	方形意味四条边相等、对称
strew	撒满，散播，点缀	金黄色的麦秆（straw）之间，零星地点缀（strew）几多红花
spout	喷出，涛涛不绝地将	区分：sprout 萌芽
squall	短暂的暴风、骚动	瑞典语 突发暴雨
sundry	各种各样的	太阳（sun）晒干（dry）各种东西（sundry）
swank	夸耀，炫耀	天鹅（swan）向丑小鸭炫耀其曲美
squint	斜视	斜眼（asquint）的缩写
subvention	补助金，津贴	音：舍部温馨
suavity	柔和，愉快	音：耍味
swill	冲洗，痛饮	游泳馆游泳后（swim），冲洗（swill）下再狂饮（swill）杯啤酒
sprain	扭伤	雨天（rain）打滑，扭伤了脚
stygian	阴暗的，阴森森的	源于环绕地狱的冥河（Styx）
spree	狂欢	源于苏格兰，猎牛（cattle raid）、战利品（booty）
stentorian	声音洪亮的	源于特洛伊战争传令官Stentor，其声如洪钟
star-crossed	时运不济的	源于西方星相学，星体交叉成十字为凶相
stoop	弯腰，俯身，屈尊	站（stood）直了别弯腰（stoop）
swig	痛饮	猪（swine）戴着假发（wig）来河边痛饮（swig）
sway	摇动，摇摆	走S形路线（way）
splice	结合，拼接	
sportive	嬉戏的，欢闹的	
squat	蹲下，矮胖的	
squeamish	神经质的，易呕吐的	
squelch	压制，镇压	
stagy	不自然的，做作的	
stammer	口吃，结巴地说	
stampede	经跑，逃窜	
stanza	（诗的）节、段	
staunch	坚定的，忠诚的	
stifle	使窒息，抑制	
stipple	点画，点刻	
stolid	无动于衷的	
stomach	吃得下，容忍	
stooge	配角，陪衬，傀儡	
strident	尖锐的，刺耳的	
strife	纷争，冲突	
strut	趾高气昂地走；支柱	
stubby	短粗的	
stultify	显得愚蠢，变得无用或无效	
stunt	阻碍（成长）；特技，绝技	
stupefy	使茫然，使惊讶	
stupendous	巨大的，惊人的	
stupor	昏迷，恍惚	
suffocate	窒息，闷死	
sulk	生气，愠怒	
sullen	忧郁的	
sunder	分裂，分离	
superlative	最好的	
supine	仰卧的，懒散的	
svelte	（女人）体态苗条的	
swart	黑黝黝的，有毒的，有害的，恶性的	
swathe	包，绑，裹	
swell	肿胀，增强	
swelter	闷热，汗流浃背，使中暑	
swindle	诈骗	
unassuming	不摆架子的，不装腔作势的，谦逊的	assuming 傲慢的，不逊的
unearthly	非尘世的，神秘的，怪异的，理想的	earthly 世俗的
unflappable	不惊慌的，镇定的	flappable 易激动不安的
ungrudging	慷慨的，情愿的	grudging 吝啬的，不情愿的
testy	暴躁的，易怒的	heady
unkempt	蓬乱的，未梳理的，不整洁的，乱糟糟的	kempt 整洁的，梳理好的
unprovoked	无缘无故的	provoke 激怒，驱使
unison	齐奏，齐唱，一致，协作	son=sound；un=one
syncretize	使结合，使融合	syn=with；希语：联合起来反对共同的敌人
tambourine	腰鼓，小手鼓	tambour 鼓，绷圈（用于刺绣）
tempest	暴风雨，骚动	temper 脾气
temporize	拖延，见风使舵	tempor=time
tensile	张力的，可伸展的	tens=tend=stretch,strain
ticklish	怕痒的，易怒的	tickle 发痒
topsy-turvy	颠倒的，相反的，乱七八糟的，混乱的	top turn
transfigure	美化，改观	trans=across
tract	传单，大片工地	treatise
tremor	触动，战栗，颤抖	trem=quiver
tremulous	颤动的，胆怯的，懦弱的	trem=quiver
tumid	肿起的，肿胀的	tum=swell up 肿大的
ultramundance	世界之外的，超俗的	ultra=beyond,mund=world
undulate	波动，起伏	und=wave
univocal	单一意思的，意义明确的	voc=voice；un=one
timeworn	陈旧的，陈腐的	worn 经历多，或长期使用有磨损
umpire	仲裁人；仲裁	出现不（um）公平（pire）则由第三人执行仲裁
sybaritic	骄奢淫逸的，贪图享乐的	古希腊城锡巴里斯（Sybaris）因富饶和奢靡而著名，510年在克罗托那战争中毁灭
tightfisted	吝啬的	紧握（tight）拳头（fist），不容手里一丝一毫外流
taking	楚楚动人的，迷人的	摄魂
toothsome	可口的，美味的	牙齿上的中国
threadbare	磨破的，陈腐的	衣服的细毛都磨掉，线头都露出来了
trounce	撞击，严惩	音：创死
tarry	耽搁	音：塔里 白素贞为法海困入塔里，耽搁了与许仙的后半生
tantrum	发脾气，发怒	音：坛醋 弄翻女友的醋坛子，后果不堪设想啊
toil	苦干，辛苦劳作	音：掏油 掏石油可比掏煤难多了
teetotal	滴酒不沾的，完全的，全部的	英国戒酒运动拥护者Turner的一次戒酒演讲口误，将total发音成teetotal
tempo	（音乐的）速度，（动作、生活的）步调，节奏	源于tempor=time
thrash	鞭打	源于thresh 脱粒，打谷；反复打击
thespian	戏剧的	源于古希腊悲剧创始人泰斯庇斯（Thespis）
swipe	猛击	
swoop	猛扑，攫取	
table	搁置，不予考虑	
tally	使一致，符合	
tamp	捣实，夯实	
tamper	干预，损坏，篡改	
tangy	气味刺激的，扑鼻的	
tart	酸的，尖酸的	
tatter	碎片；撕碎	
tattle	闲聊，泄露秘密	
tatty	破旧的，褴褛的，破败的	
teeter	摇摇欲坠，步履蹒跚，踌躇	
temerity	鲁莽，大胆	
thaw	解冻，融化	
throe	剧痛	
throng	一大群；拥挤	
thump	重击，撞击	
tiff	口角，小争吵	
tilt	使倾斜；倾斜，斜坡	
timbre	音色，音质	
tinder	火绒，火种	
tinge	给着色，使略带气息	
tinkle	发出叮当声	
tirade	长篇的攻击性演说	
to-do	喧闹，骚乱	
tome	册，卷，大部头的书	
torrid	酷热的	
totter	摇摇欲坠，步履蹒跚	
tractability	温顺	
traduce	诽谤	
traipse	散步，闲逛	
tramp	重步走	
transience	短暂，稍纵即逝	
trapeze	高空秋千，吊架	
travesty	滑稽地模仿	
trek	艰苦跋涉	
trifle	微不足道的事物，琐事	
trinket	小装饰品，不值钱的珠宝，琐事	
troll	钓鱼，放声高歌	
truant	逃避责任的；逃避学习、工作等的人	
trudge	跋涉	
trumpery	中看不中用的	
tumble	突然跌倒，突然下跌，倒塌	
tumult	喧哗，吵闹，骚动，骚乱	
turgid	肿胀的，浮夸的	
tusk	（象等的）长牙	
twee	矫揉造作的，故做多情的	
twinge	（生理、心理上的）剧痛	
tyro	新手	
unbidden	未经邀请的	
unconscionable	无节制的，过度的，不合理的	
uncouth	粗野的，笨拙的	
underbid	叫价低于，要价低	
underdog	居于下风的人，受欺压的人	
undergrid	从底层支持，加固的底部	
understudy	预备演员，替角；充当替角	
unravel	拆开，拆散，解开	
vantage	优势，有利地位	advantage；disadvantage
upbraid	斥责，责骂	braid=twist 抓住（up）别人的小辫子（braid）
well-groomed	整洁干净的，衣着时尚的	groom 新郎官
upheaval	动乱，剧变	heave 举起
unregenerate	不悔改的	regenerate 再生，重生
unrepentant	顽固不化的，不后悔的	repentant 后悔的
valediction	告别演说，告别辞	vale=farewell；dict=say,declare
vapid	索然无味，无生气的	vap=lack of
vaporous	空想的，多蒸汽的	vapor 蒸汽
vegetate	像植物那样生长，无所事事的生活	vegetable 蔬菜，植物，生活单调呆板的人
veritable	名符其实的，真正的	ver=true
verbiage	冗词，废话	verb=word
verdure	葱郁，青翠，生机勃勃	verd=green
vernal	春季的，春季般的，青春的	vern=spring
versant	精通的；山坡，斜坡	vers=vert=turn
vertigo	眩晕	vert=turn
vestment	官服，礼服，法衣	vest
vile	恶劣的，卑鄙的，道德败坏的	vil=base
virie	有男子气的，刚健的	vir=man
virtuosity	精湛技巧	vir=man；virtuoso 大师
viscid	粘性的	visc=thick 厚且胶粘的
visceral	内心深处的，内脏的	viscer=internal organ
vivacious	活泼的，有生气的，快活的	viv=life
volition	意志，决断力	vol=wish
voracity	贪食，贪婪	vor=swallow
votary	崇拜者，热心支持者	vot=vow
waggish	诙谐的，滑稽的	wag 摇摆，打趣的人
vagrancy	漂泊，流浪	wag=wonder 浪迹天涯
waspish	易怒的，尖刻的	wasp 黄蜂
wastrel	挥霍无度的人	waste
wispy	纤细的，脆弱的，一缕一缕的	wispy hair
wrought	做成的，形成的，精制的	work的一种过去式
volley	齐发，群射，截击；网球	动词多衍生于网球运动中的战术
welsh	欠债不还，失信	对于威尔士人的一种偏见，认为他们常耍赖、欠债不还
whine	哀嚎，嚎哭	酒(wine)品好差，一喝高就鬼哭狼嚎(whine)
wheeze	喘息，发出呼哧呼哧的声音	拟声词
wallow	打滚，沉迷	墙（wall）根（low）打泥的猪，热衷于此啊
wallop	重击，猛击	墙（wall）上一个洞（hole），打出来的
waylay	埋伏，伏击	守（lay）在路（way）旁
vista	远景，展望	微软发布的vista操作系统，寓意展望未来
waddle	摇摆地走	音：歪倒
wanton	无节制的，肆无忌惮的；嬉戏的，淘气的	音：顽童
vouch	担保，保证	音：握契 手握契约为某事担保
vagary	奇想，异想天开	音：无规律；wag=wonder 思想漫游
yen	渴望	音：瘾
vying	竞争的	源于vie 竞争
whim	一时的兴致、怪念头	源于whim-wham 奇装异服的简写；区分whip（鞭打、抽打）
vandalize	肆意破坏	曾侵入罗马帝国的汪达尔人（Vandal），日耳曼民族的一支，以故意破坏艺术品而臭名昭著
upfront	坦率的	
vanquish	征服，击溃	
vaunt	吹嘘的，自夸	
vendetta	宿怨，深仇	
verboten	禁止的，严禁的	
vest	授予，赋予；内衣，汗衫	
vicar	教区牧师	
vicarious	代理人的，替代的	
vie	竞争	
vintage	经典的，最好的	
vituperate	谩骂，辱骂	
voucher	证件，收据，凭证，代金券	
wacky	（行为等）古怪的，乖僻的	
waive	放弃，推迟	
wan	苍白的，病态的	
wean	（孩子）断奶，戒掉	
weird	古怪的，怪诞的	
wend	行、走、前进	
wheedle	哄骗，诱骗	
whet	磨快，刺激	
whiff	（风、烟等的）一阵；轻吹	
whimper	啜泣，呜咽	
whit	一点儿，少量	
wholesome	有益健康的	
whoop	高喊，欢呼	
wield	行使（权力），支配，控制	
wiggle	扭动，摆动，犹豫	
wigwag	摇动，摇摆	
wile	诡计	
wince	畏缩，退缩	
windfall	被风吹落的果实，意外收获，横财	
wink	使眼色，眨眼示意	
winkle	挑出，剔出，取出	
winnow	扬，簸（谷物），除去	
wiry	瘦而结实的	
wizen	干枯的，干瘪的，干皱的	
wobble	摇晃，摇摆，犹豫	
woe	悲痛，悲哀，不幸，灾难	
woo	求爱，求婚，恳求，争取	
wrath	愤怒，愤慨	
wretch	可怜的人，卑鄙的人	
writ	令状，书面命令，正式文件	
wroth	暴怒的，激怒的	
yacht	帆船，游艇	
yank	猛拉，拽	
yielding	易弯曲的，柔软的，顺从的，服从的	
yowl	嚎叫，恸哭	
yummy	美味的，可口的	
zephyr	和风，西风	
zest	刺激性，兴趣，热心	
fluke	侥幸；偶然事件	区分flack 高射炮；广告宣传
loath	不情愿的，勉强的	